laua,laua_name,All Premises,All Matched Premises,SFBB availability (% premises),UFBB (100Mbit/s) availability (% premises),UFBB availability (% premises),Full Fibre availability (% premises),Gigabit availability (% premises),% of premises unable to receive 2Mbit/s,% of premises unable to receive 5Mbit/s,% of premises unable to receive 10Mbit/s,% of premises unable to receive 30Mbit/s,% of premises below the USO,% of premises with NGA,% of premises able to receive decent broadband from FWA,Number of premises with SFBB availability,Number of premises with UFBB (100Mbit/s) availability,Number of premises with UFBB availability,Number of premises with Full Fibre availability,Number of premises with Gigabit availability,Number of premises unable to receive 2Mbit/s,Number of premises unable to receive 5Mbit/s,Number of premises unable to receive 10Mbit/s,Number of premises unable to receive 30Mbit/s,Number of premises below the USO,Number of premises with NGA,Number of premises able to receive decent broadband from FWA,Number of premises with 30<300Mbit/s download speed,Number of premises with >=300Mbit/s download speed,Number of premises with 0<2Mbit/s download speed,Number of premises with 2<5Mbit/s download speed,Number of premises with 5<10Mbit/s download speed,Number of premises with 10<30Mbit/s download speed,% of premises with 30<300Mbit/s download speed,% of premises with >=300Mbit/s download speed,% of premises with 0<2Mbit/s download speed,% of premises with 2<5Mbit/s download speed,% of premises with 5<10Mbit/s download speed,% of premises with 10<30Mbit/s download speed
S12000033,ABERDEEN CITY,119226,119044,95.2,49.9,42.4,35.7,35.7,0.0,0.1,0.6,4.7,0.2,97.6,0.0,113457,59494,50514,42566,42566,38,164,768,5587,249,116382,0,62943,50514,38,126,604,4819,52.8,42.4,0.0,0.1,0.5,4.0
S12000034,ABERDEENSHIRE,118041,117265,82.9,7.5,7.2,7.1,7.1,2.6,5.7,9.2,16.4,3.5,94.8,0.0,97857,8797,8551,8412,8412,3049,6708,10828,19408,4181,111847,0,89306,8551,3049,3659,4120,8580,75.7,7.2,2.6,3.1,3.5,7.3
E07000223,ADUR,28243,28229,99.0,87.5,87.4,0.6,0.6,0.0,0.0,0.1,1.0,0.1,99.6,0.0,27956,24725,24688,178,178,0,6,28,273,23,28136,0,3268,24688,0,6,22,245,11.6,87.4,0.0,0.0,0.1,0.9
E07000026,ALLERDALE,46579,46506,93.2,2.9,2.9,2.9,2.9,1.1,2.1,3.0,6.6,0.9,99.1,1.6,43429,1331,1331,1331,1331,516,973,1399,3077,433,46139,762,42098,1331,516,457,426,1678,90.4,2.9,1.1,1.0,0.9,3.6
E07000032,AMBER VALLEY,57161,57046,95.0,31.1,27.4,24.3,24.3,0.1,0.4,0.8,4.8,0.3,99.2,0.0,54326,17749,15658,13889,13889,51,230,459,2720,195,56683,0,38668,15658,51,179,229,2261,67.6,27.4,0.1,0.3,0.4,4.0
S12000041,ANGUS,57044,56621,86.9,14.9,14.7,2.0,2.0,1.4,3.7,6.9,12.3,2.4,95.4,0.0,49584,8484,8368,1148,1148,781,2125,3909,7037,1358,54424,0,41216,8368,781,1344,1784,3128,72.3,14.7,1.4,2.4,3.1,5.5
N09000001,ANTRIM AND NEWTOWNABBEY,57540,57341,92.1,77.1,76.9,65.5,65.5,1.6,3.0,3.8,7.5,1.2,99.0,0.0,53016,44369,44242,37698,37698,940,1721,2171,4325,672,56941,0,8774,44242,940,781,450,2154,15.2,76.9,1.6,1.4,0.8,3.7
N09000011,ARDS AND NORTH DOWN,68863,68733,94.8,71.5,71.3,69.6,69.6,0.6,1.2,2.1,5.0,0.8,99.7,0.0,65274,49252,49100,47902,47902,398,797,1475,3459,536,68636,0,16174,49100,398,399,678,1984,23.5,71.3,0.6,0.6,1.0,2.9
S12000035,ARGYLL AND BUTE,49115,48018,79.4,1.6,1.6,1.6,1.6,2.8,5.3,9.5,18.4,6.7,89.7,0.0,38988,786,786,785,786,1382,2610,4678,9030,3315,44041,0,38202,786,1382,1228,2068,4352,77.8,1.6,2.8,2.5,4.2,8.9
N09000002,"ARMAGH CITY, BANBRIDGE AND CRAIGAVON",80209,79893,88.2,59.0,58.2,59.0,59.0,1.6,3.2,5.0,11.4,2.0,98.4,0.2,70776,47315,46645,47315,47315,1245,2548,4008,9117,1584,78930,134,24131,46645,1245,1303,1460,5109,30.1,58.2,1.6,1.6,1.8,6.4
E07000224,ARUN,75103,75049,96.7,9.7,6.1,3.5,3.5,0.1,0.2,0.4,3.3,0.1,99.7,0.0,72597,7288,4600,2594,2594,89,126,274,2452,105,74842,0,67997,4600,89,37,148,2178,90.5,6.1,0.1,0.0,0.2,2.9
E07000170,ASHFIELD,56003,55929,98.6,89.1,88.8,3.8,3.8,0.0,0.3,0.3,1.3,0.2,99.2,0.0,55205,49926,49726,2134,2134,3,164,183,724,133,55541,0,5479,49726,3,161,19,541,9.8,88.8,0.0,0.3,0.0,1.0
E07000105,ASHFORD,54235,54149,90.9,49.8,46.9,7.7,7.7,0.4,1.6,3.3,8.9,0.9,98.6,0.0,49299,27002,25419,4171,4171,197,889,1782,4850,513,53500,0,23880,25419,197,692,893,3068,44.0,46.9,0.4,1.3,1.6,5.7
E07000200,BABERGH,40608,40527,93.8,12.9,12.6,8.3,8.3,0.4,0.8,1.3,6.0,0.6,99.0,0.0,38073,5226,5113,3361,3361,147,329,537,2454,249,40219,0,32960,5113,147,182,208,1917,81.2,12.6,0.4,0.4,0.5,4.7
E09000002,BARKING AND DAGENHAM,76819,76798,99.3,88.7,88.6,52.3,52.3,0.0,0.3,0.3,0.7,0.0,99.3,0.0,76265,68104,68096,40209,40209,10,198,256,533,16,76273,0,8169,68096,10,188,58,277,10.6,88.6,0.0,0.2,0.1,0.4
E09000003,BARNET,152038,151907,97.6,58.8,55.0,21.4,21.4,0.0,0.0,0.0,2.3,0.1,98.5,0.0,148338,89336,83619,32472,32472,0,16,66,3569,131,149732,0,64719,83619,0,16,50,3503,42.6,55.0,0.0,0.0,0.0,2.3
E08000016,BARNSLEY,111622,111403,98.3,69.9,66.2,22.6,22.6,0.1,0.2,0.2,1.5,0.2,99.4,0.0,109693,78054,73861,25179,25180,71,168,253,1710,242,110944,0,35832,73861,71,97,85,1457,32.1,66.2,0.1,0.1,0.1,1.3
E07000027,BARROW-IN-FURNESS,33724,33698,98.6,0.9,0.9,0.9,0.9,0.1,0.2,0.3,1.3,0.1,99.9,0.1,33266,294,294,294,294,44,68,105,432,46,33696,34,32972,294,44,24,37,327,97.8,0.9,0.1,0.1,0.1,1.0
E07000066,BASILDON,78798,78656,97.9,74.2,72.9,15.1,15.1,0.0,0.1,0.2,1.9,0.2,99.6,0.0,77159,58491,57472,11877,11877,5,65,175,1497,145,78475,0,19687,57472,5,60,110,1322,25.0,72.9,0.0,0.1,0.1,1.7
E07000084,BASINGSTOKE AND DEANE,76982,76909,96.3,53.2,51.6,17.5,51.3,0.2,0.5,1.0,3.6,0.5,99.1,0.0,74162,40969,39714,13477,39509,116,393,779,2747,367,76280,0,34448,39714,116,277,386,1968,44.7,51.6,0.2,0.4,0.5,2.6
E07000171,BASSETLAW,52971,52819,96.1,34.1,27.4,6.4,6.4,0.4,0.7,1.0,3.7,0.4,99.3,6.8,50882,18060,14524,3366,3366,193,354,530,1937,238,52607,3622,36358,14524,193,161,176,1407,68.6,27.4,0.4,0.3,0.3,2.7
E06000022,BATH AND NORTH EAST SOMERSET,83070,82937,91.8,59.1,52.4,21.2,21.2,0.3,0.7,1.6,8.1,0.5,95.7,0.0,76235,49134,43519,17570,17570,224,577,1354,6702,425,79461,0,32716,43519,224,353,777,5348,39.4,52.4,0.3,0.4,0.9,6.4
E06000055,BEDFORD,76593,76560,97.7,75.1,72.3,9.3,9.3,0.1,0.3,0.6,2.2,0.1,99.4,0.0,74849,57552,55345,7147,7147,65,203,432,1711,97,76120,0,19504,55345,65,138,229,1279,25.5,72.3,0.1,0.2,0.3,1.7
N09000003,BELFAST,153846,153675,99.0,93.4,93.4,73.4,73.4,0.0,0.0,0.2,0.9,0.1,99.1,0.0,152251,143670,143666,112863,112863,14,27,257,1424,168,152521,0,8585,143666,14,13,230,1167,5.6,93.4,0.0,0.0,0.1,0.8
E09000004,BEXLEY,98306,98205,98.3,79.6,78.6,27.4,27.4,0.0,0.0,0.2,1.6,0.1,98.8,0.0,96621,78300,77230,26926,26926,1,6,154,1584,99,97164,0,19391,77230,1,5,148,1430,19.7,78.6,0.0,0.0,0.2,1.5
E08000025,BIRMINGHAM,440137,439445,97.2,91.9,91.2,33.1,90.6,0.0,0.1,0.6,2.6,0.2,97.3,0.0,427907,404554,401399,145552,398789,22,292,2580,11538,711,428180,0,26508,401399,22,270,2288,8958,6.0,91.2,0.0,0.1,0.5,2.0
E07000129,BLABY,43081,43053,98.2,74.1,71.0,33.8,33.8,0.0,0.2,0.3,1.8,0.1,99.1,0.0,42298,31904,30585,14555,14555,21,71,109,755,33,42683,0,11713,30585,21,50,38,646,27.2,71.0,0.0,0.1,0.1,1.5
E06000008,BLACKBURN WITH DARWEN,61061,61017,98.1,70.1,69.8,9.8,9.8,0.0,0.2,0.4,1.9,0.1,99.5,23.3,59878,42792,42642,5974,5982,25,111,264,1139,68,60740,14213,17236,42642,25,86,153,875,28.2,69.8,0.0,0.1,0.3,1.4
E06000009,BLACKPOOL,72173,72148,99.1,73.1,73.0,0.5,0.5,0.0,0.0,0.0,0.9,0.0,99.3,0.0,71527,52737,52681,392,392,1,8,24,621,25,71648,0,18846,52681,1,7,16,597,26.1,73.0,0.0,0.0,0.0,0.8
W06000019,BLAENAU GWENT,32822,32800,97.0,4.7,3.4,2.3,2.3,0.0,0.1,0.4,3.0,0.1,99.7,0.0,31822,1545,1120,740,740,13,34,131,978,36,32739,15,30702,1120,13,21,97,847,93.5,3.4,0.0,0.1,0.3,2.6
E07000033,BOLSOVER,36514,36470,95.3,42.7,37.9,13.8,13.8,0.1,0.1,0.3,4.6,0.2,99.0,0.0,34784,15588,13824,5026,5026,22,53,101,1686,61,36140,0,20960,13824,22,31,48,1585,57.4,37.9,0.1,0.1,0.1,4.3
E08000001,BOLTON,124287,124242,98.6,87.7,85.7,1.1,84.3,0.0,0.1,0.3,1.3,0.0,99.4,0.0,122571,108968,106550,1402,104738,22,102,353,1671,50,123522,0,16021,106550,22,80,251,1318,12.9,85.7,0.0,0.1,0.2,1.1
E07000136,BOSTON,30965,30772,91.1,4.5,4.5,4.5,4.5,0.6,1.5,2.2,8.3,1.3,97.6,3.1,28195,1391,1391,1391,1391,195,453,693,2577,418,30219,946,26804,1391,195,258,240,1884,86.6,4.5,0.6,0.8,0.8,6.1
E06000058,"BOURNEMOUTH, CHRISTCHURCH AND POOLE",185690,184955,98.4,82.4,79.7,20.5,20.5,0.2,0.2,0.3,1.2,0.4,99.2,0.0,182690,152948,148030,38110,38110,303,313,496,2265,752,184182,0,34660,148030,303,10,183,1769,18.7,79.7,0.2,0.0,0.1,1.0
E06000036,BRACKNELL FOREST,52088,52040,96.3,62.0,58.4,6.5,56.1,0.2,0.3,0.9,3.6,0.2,98.6,0.0,50160,32311,30417,3361,29244,80,159,489,1880,97,51345,0,19743,30417,80,79,330,1391,37.9,58.4,0.2,0.2,0.6,2.7
E08000032,BRADFORD,197578,197152,96.9,82.1,79.9,3.5,78.4,0.1,0.2,0.5,2.9,0.2,98.3,21.2,191368,162264,157941,6914,154901,160,458,890,5784,462,194181,41859,33427,157941,160,298,432,4894,16.9,79.9,0.1,0.2,0.2,2.5
E07000067,BRAINTREE,65917,65780,92.7,11.7,11.7,11.7,11.7,0.5,1.5,2.6,7.1,1.3,96.4,0.0,61131,7725,7725,7690,7690,321,1017,1693,4649,884,63547,0,53406,7725,321,696,676,2956,81.0,11.7,0.5,1.1,1.0,4.5
E07000143,BRECKLAND,61779,61663,90.4,14.5,12.8,11.5,11.5,0.6,1.6,2.7,9.4,1.5,97.7,0.0,55859,8979,7916,7115,7115,367,1003,1695,5804,899,60356,0,47943,7916,367,636,692,4109,77.6,12.8,0.6,1.0,1.1,6.7
E09000005,BRENT,125045,124650,97.8,70.6,68.4,24.7,24.7,0.0,0.0,0.2,1.9,0.3,97.9,0.0,122252,88324,85570,30861,30861,0,23,300,2398,394,122361,0,36682,85570,0,23,277,2098,29.3,68.4,0.0,0.0,0.2,1.7
E07000068,BRENTWOOD,33474,33420,95.4,4.0,4.0,4.0,4.0,0.1,0.2,0.4,4.5,0.2,99.6,0.0,31929,1355,1355,1355,1355,25,70,127,1491,76,33327,0,30574,1355,25,45,57,1364,91.3,4.0,0.1,0.1,0.2,4.1
W06000013,BRIDGEND,64119,64090,97.1,39.9,29.6,23.1,23.1,0.0,0.1,0.8,2.9,0.1,99.0,36.4,62249,25607,18977,14806,14806,29,69,481,1841,36,63463,23326,43272,18977,29,40,412,1360,67.5,29.6,0.0,0.1,0.6,2.1
E06000043,BRIGHTON AND HOVE,131408,131235,98.4,86.4,83.5,2.0,2.0,0.0,0.0,0.3,1.5,0.1,98.6,0.0,129296,113471,109713,2603,2603,2,61,339,1939,175,129506,0,19583,109713,2,59,278,1600,14.9,83.5,0.0,0.0,0.2,1.2
E06000023,"BRISTOL, CITY OF",198963,198728,96.6,90.2,89.3,45.8,45.8,0.0,0.0,0.3,3.3,0.1,96.7,0.0,192175,179384,177669,91224,91224,0,65,652,6553,235,192440,0,14506,177669,0,65,587,5901,7.3,89.3,0.0,0.0,0.3,3.0
E07000144,BROADLAND,58412,58228,94.3,43.8,40.5,7.4,7.4,0.2,0.7,1.5,5.3,1.1,98.6,0.0,55108,25575,23686,4317,4317,129,438,884,3120,614,57606,0,31422,23686,129,309,446,2236,53.8,40.5,0.2,0.5,0.8,3.8
E09000006,BROMLEY,140463,140414,97.9,87.4,87.1,3.2,3.2,0.0,0.2,0.4,2.1,0.1,98.8,0.0,137481,122734,122395,4499,4499,53,329,572,2933,91,138782,0,15086,122395,53,276,243,2361,10.7,87.1,0.0,0.2,0.2,1.7
E07000234,BROMSGROVE,41809,41745,96.2,53.6,53.5,32.3,53.6,0.1,0.4,0.8,3.6,0.3,99.6,0.1,40233,22421,22352,13512,22392,37,187,327,1512,114,41642,41,17881,22352,37,150,140,1185,42.8,53.5,0.1,0.4,0.3,2.8
E07000095,BROXBOURNE,40871,40855,98.7,89.4,86.4,3.9,3.9,0.1,0.1,0.2,1.2,0.1,99.4,0.0,40357,36529,35327,1578,1578,24,35,68,498,21,40633,0,5030,35327,24,11,33,430,12.3,86.4,0.1,0.0,0.1,1.1
E07000172,BROXTOWE,49991,49963,99.0,90.5,85.6,1.2,1.2,0.0,0.1,0.2,0.9,0.1,99.7,0.0,49511,45258,42796,578,578,14,32,77,452,27,49842,0,6715,42796,14,18,45,375,13.4,85.6,0.0,0.0,0.1,0.8
E06000060,BUCKINGHAMSHIRE,226036,225696,94.2,46.9,41.4,8.9,14.7,0.2,0.6,1.6,5.6,0.4,98.3,0.0,212933,105971,93565,20111,33172,340,1377,3554,12763,849,222254,0,119368,93565,340,1037,2177,9209,52.8,41.4,0.2,0.5,1.0,4.1
E07000117,BURNLEY,41410,41383,98.6,81.7,81.7,0.9,81.7,0.1,0.1,0.3,1.3,0.1,99.8,4.6,40841,33841,33839,379,33838,27,42,120,542,41,41323,1906,7002,33839,27,15,78,422,16.9,81.7,0.1,0.0,0.2,1.0
E08000002,BURY,83327,83149,97.7,61.1,55.2,24.4,50.8,0.0,0.1,0.2,2.1,0.2,99.7,0.0,81422,50888,45972,20352,42342,12,77,153,1727,178,83101,0,35450,45972,12,65,76,1574,42.5,55.2,0.0,0.1,0.1,1.9
W06000018,CAERPHILLY,79182,79158,97.9,25.4,19.8,16.4,16.4,0.0,0.1,0.2,2.0,0.0,99.8,47.2,77556,20090,15670,13000,13001,37,70,151,1602,30,79048,37348,61886,15670,37,33,81,1451,78.2,19.8,0.0,0.0,0.1,1.8
E08000033,CALDERDALE,94422,94364,95.6,50.3,49.9,11.4,11.4,0.1,0.4,0.7,4.4,0.1,99.2,0.0,90221,47519,47081,10762,10762,88,333,698,4143,103,93655,3,43140,47081,88,245,365,3445,45.7,49.9,0.1,0.3,0.4,3.6
E07000008,CAMBRIDGE,57058,57007,98.7,90.1,87.8,21.3,21.3,0.0,0.0,0.1,1.2,0.1,98.8,0.4,56336,51403,50070,12166,12166,0,2,77,671,51,56362,251,6266,50070,0,2,75,594,11.0,87.8,0.0,0.0,0.1,1.0
E09000007,CAMDEN,104538,103997,97.6,89.9,89.2,27.1,27.1,0.0,0.0,0.0,1.9,0.5,97.6,0.0,102008,94029,93246,28369,28369,0,0,35,1989,535,102010,0,8762,93246,0,0,35,1954,8.4,89.2,0.0,0.0,0.0,1.9
E07000192,CANNOCK CHASE,43896,43861,98.2,25.8,25.7,3.3,25.6,0.0,0.1,0.1,1.7,0.1,99.8,0.0,43107,11332,11292,1457,11224,7,28,31,754,49,43812,0,31815,11292,7,21,3,723,72.5,25.7,0.0,0.0,0.0,1.6
E07000106,CANTERBURY,69091,68888,93.9,3.3,3.3,3.3,3.3,0.2,0.6,1.0,5.8,0.5,99.5,0.0,64874,2246,2246,2246,2246,172,414,725,4014,378,68723,0,62628,2246,172,242,311,3289,90.6,3.3,0.2,0.4,0.5,4.8
W06000015,CARDIFF,154029,153954,98.9,87.7,85.1,44.9,44.9,0.0,0.0,0.2,1.0,0.0,99.4,63.0,152403,135070,131072,69121,69121,22,73,232,1551,75,153152,97026,21331,131072,22,51,159,1319,13.8,85.1,0.0,0.0,0.1,0.9
E07000028,CARLISLE,52539,52393,94.2,56.8,50.2,5.7,5.7,0.7,1.5,3.0,5.6,1.3,97.7,0.1,49467,29819,26370,2970,2970,392,796,1599,2926,678,51310,34,23097,26370,392,404,803,1327,44.0,50.2,0.7,0.8,1.5,2.5
W06000010,CARMARTHENSHIRE,86923,86384,86.6,19.8,19.8,19.8,19.8,2.0,4.4,6.9,12.8,2.4,93.9,13.0,75285,17208,17208,17205,17205,1771,3853,5959,11099,2082,81585,11289,58077,17208,1771,2082,2106,5140,66.8,19.8,2.0,2.4,2.4,5.9
E07000069,CASTLE POINT,38622,38438,98.9,45.4,45.4,2.3,2.3,0.0,0.0,0.1,0.6,0.5,99.3,0.0,38189,17544,17534,897,897,1,16,23,249,184,38364,0,20655,17534,1,15,7,226,53.5,45.4,0.0,0.0,0.0,0.6
N09000004,CAUSEWAY COAST AND GLENS,61560,60551,85.5,42.4,42.4,42.4,42.4,2.5,4.6,6.2,12.9,3.4,97.7,0.0,52636,26102,26087,26100,26100,1510,2822,3844,7915,2123,60136,0,26549,26087,1510,1312,1022,4071,43.1,42.4,2.5,2.1,1.7,6.6
E06000056,CENTRAL BEDFORDSHIRE,120826,120725,97.1,67.9,64.7,12.2,12.2,0.1,0.5,0.8,2.8,0.2,99.2,0.0,117332,82025,78203,14746,14746,104,639,1011,3393,246,119853,0,39129,78203,104,535,372,2382,32.4,64.7,0.1,0.4,0.3,2.0
W06000008,CEREDIGION,34701,34480,80.1,20.7,20.7,20.7,20.7,3.1,7.3,11.9,19.3,4.7,88.9,3.5,27784,7169,7169,7169,7169,1086,2523,4145,6696,1624,30853,1226,20615,7169,1086,1437,1622,2551,59.4,20.7,3.1,4.1,4.7,7.4
E07000130,CHARNWOOD,75088,74838,98.4,75.7,72.8,10.1,10.1,0.0,0.1,0.3,1.3,0.4,99.3,0.0,73869,56877,54647,7577,7577,20,78,199,969,281,74547,0,19222,54647,20,58,121,770,25.6,72.8,0.0,0.1,0.2,1.0
E07000070,CHELMSFORD,77712,77640,95.1,60.1,56.9,32.5,32.5,0.1,0.3,0.7,4.8,0.2,98.6,0.0,73942,46711,44251,25293,25293,44,216,519,3698,158,76647,0,29691,44251,44,172,303,3179,38.2,56.9,0.1,0.2,0.4,4.1
E07000078,CHELTENHAM,56463,56329,98.7,76.0,68.8,2.2,2.2,0.0,0.1,0.2,1.1,0.2,99.2,0.0,55734,42916,38845,1263,1263,9,30,115,595,141,55988,0,16889,38845,9,21,85,480,29.9,68.8,0.0,0.0,0.2,0.9
E07000177,CHERWELL,66424,66339,96.8,48.6,39.1,10.4,10.4,0.2,0.4,0.9,3.1,0.3,98.9,0.0,64276,32284,25988,6936,6936,154,252,600,2063,170,65720,0,38288,25988,154,98,348,1463,57.6,39.1,0.2,0.1,0.5,2.2
E06000049,CHESHIRE EAST,177855,177684,94.0,45.5,38.6,9.2,17.3,0.3,0.8,1.4,5.9,0.3,98.7,1.5,167117,80909,68656,16441,30831,493,1343,2526,10567,530,175457,2672,98461,68656,493,850,1183,8041,55.4,38.6,0.3,0.5,0.7,4.5
E06000050,CHESHIRE WEST AND CHESTER,159274,159144,95.4,46.2,39.3,20.4,20.4,0.1,0.5,1.1,4.5,0.2,99.2,0.5,152004,73596,62552,32478,32478,228,863,1767,7140,303,157921,736,89452,62552,228,635,904,5373,56.2,39.3,0.1,0.4,0.6,3.4
E07000034,CHESTERFIELD,49457,49440,97.8,56.1,42.7,23.4,23.4,0.0,0.0,0.2,2.1,0.0,99.9,0.0,48380,27766,21135,11550,11550,0,3,86,1060,17,49408,0,27245,21135,0,3,83,974,55.1,42.7,0.0,0.0,0.2,2.0
E07000225,CHICHESTER,57253,56928,91.4,22.6,20.5,19.1,19.1,0.3,0.8,1.9,8.0,1.3,98.7,0.0,52346,12912,11759,10919,10919,175,480,1065,4582,720,56495,0,40587,11759,175,305,585,3517,70.9,20.5,0.3,0.5,1.0,6.1
E07000118,CHORLEY,51434,51347,95.8,59.8,56.1,11.8,11.8,0.0,0.2,0.7,4.0,0.2,99.2,5.0,49266,30761,28855,6045,6045,24,102,343,2081,115,51032,2589,20411,28855,24,78,241,1738,39.7,56.1,0.0,0.2,0.5,3.4
S12000036,CITY OF EDINBURGH,248802,248734,98.3,87.3,85.6,40.6,84.1,0.0,0.1,0.3,1.7,0.0,98.6,0.0,244452,217107,212913,100932,209289,91,351,643,4282,85,245370,0,31539,212913,91,260,292,3639,12.7,85.6,0.0,0.1,0.1,1.5
E09000001,CITY OF LONDON,7035,7022,78.1,66.7,66.7,66.3,66.3,0.0,0.0,0.0,21.7,0.2,78.1,0.0,5492,4689,4689,4664,4664,0,0,0,1530,13,5492,0,803,4689,0,0,0,1530,11.4,66.7,0.0,0.0,0.0,21.7
S12000005,CLACKMANNANSHIRE,24832,24659,93.9,19.5,7.7,2.8,2.8,0.1,0.2,0.3,5.4,0.8,99.1,0.0,23315,4830,1922,687,687,25,41,86,1344,195,24612,0,21393,1922,25,16,45,1258,86.2,7.7,0.1,0.1,0.2,5.1
E07000071,COLCHESTER,82441,81936,94.4,54.6,54.5,7.8,7.8,0.2,1.0,1.8,5.0,1.2,96.5,0.0,77825,45000,44959,6442,6442,167,798,1493,4111,1022,79595,0,32866,44959,167,631,695,2618,39.9,54.5,0.2,0.8,0.8,3.2
W06000003,CONWY,54991,54935,93.4,7.5,7.5,7.5,7.5,0.8,1.9,3.2,6.5,1.1,97.5,58.8,51388,4113,4113,4113,4113,437,1060,1751,3547,609,53594,32310,47275,4113,437,623,691,1796,86.0,7.5,0.8,1.1,1.3,3.3
E07000029,COPELAND,33596,33547,95.2,1.6,1.6,1.6,1.6,0.3,0.7,1.4,4.6,0.8,99.3,0.0,31998,521,521,521,521,108,249,460,1549,262,33364,0,31477,521,108,141,211,1089,93.7,1.6,0.3,0.4,0.6,3.2
E07000150,CORBY,30535,30506,98.4,78.7,64.8,21.2,21.2,0.1,0.2,0.2,1.5,0.2,98.8,0.0,30053,24038,19784,6488,6488,16,66,70,453,74,30180,0,10269,19784,16,50,4,383,33.6,64.8,0.1,0.2,0.0,1.3
E06000052,CORNWALL,266665,265721,89.5,36.1,34.7,31.6,31.6,0.2,0.8,1.8,10.1,0.8,94.5,3.1,238672,96314,92425,84140,84140,649,2188,4688,27049,2047,252087,8285,146247,92425,649,1539,2500,22361,54.8,34.7,0.2,0.6,0.9,8.4
E07000079,COTSWOLD,43094,43037,92.8,36.1,36.0,35.8,35.8,0.1,0.7,1.5,7.1,0.9,94.8,0.0,39979,15577,15500,15442,15442,55,286,663,3058,381,40843,0,24479,15500,55,231,377,2395,56.8,36.0,0.1,0.5,0.9,5.6
E06000047,COUNTY DURHAM,244732,244563,94.1,24.6,20.2,15.9,15.9,0.3,0.7,1.3,5.8,0.4,99.0,0.2,230406,60186,49322,38883,38883,702,1677,3093,14157,916,242254,602,181084,49322,702,975,1416,11064,74.0,20.2,0.3,0.4,0.6,4.5
E08000026,COVENTRY,140878,140618,97.8,89.8,89.7,67.1,89.7,0.0,0.3,0.5,2.0,0.2,98.0,0.0,137774,126550,126361,94489,126411,7,444,761,2844,257,138021,0,11413,126361,7,437,317,2083,8.1,89.7,0.0,0.3,0.2,1.5
E07000163,CRAVEN,27721,27656,92.2,22.1,16.8,11.7,11.7,1.0,2.0,3.2,7.6,0.8,97.6,34.7,25546,6123,4646,3243,3254,284,551,886,2110,217,27055,9609,20900,4646,284,267,335,1224,75.4,16.8,1.0,1.0,1.2,4.4
E07000226,CRAWLEY,45912,45751,98.9,86.4,86.0,2.6,2.6,0.0,0.0,0.1,0.7,0.4,99.3,0.0,45419,39678,39491,1181,1181,7,10,29,332,162,45575,0,5928,39491,7,3,19,303,12.9,86.0,0.0,0.0,0.0,0.7
E09000008,CROYDON,160793,160101,96.6,85.4,84.7,20.2,20.2,0.0,0.0,0.1,3.0,0.4,97.2,0.0,155320,137351,136271,32444,32444,1,4,170,4781,694,156284,0,19049,136271,1,3,166,4611,11.8,84.7,0.0,0.0,0.1,2.9
E07000096,DACORUM,64831,64786,97.2,79.2,76.8,4.5,4.5,0.0,0.2,0.5,2.8,0.2,99.3,0.0,62989,51331,49803,2922,2922,27,131,303,1797,120,64370,0,13186,49803,27,104,172,1494,20.3,76.8,0.0,0.2,0.3,2.3
E06000005,DARLINGTON,51280,51234,95.2,85.4,85.0,2.3,2.3,0.6,1.3,2.5,4.7,0.4,96.7,22.5,48807,43768,43584,1189,1189,293,669,1285,2427,184,49563,11563,5223,43584,293,376,616,1142,10.2,85.0,0.6,0.7,1.2,2.2
E07000107,DARTFORD,46623,46607,97.1,56.2,52.6,15.4,15.4,0.2,0.4,0.9,2.9,0.0,99.3,0.0,45251,26200,24516,7196,7196,87,184,416,1356,18,46286,0,20735,24516,87,97,232,940,44.5,52.6,0.2,0.2,0.5,2.0
E07000151,DAVENTRY,36040,36004,95.7,36.8,30.8,25.5,25.5,0.2,0.6,1.3,4.2,0.2,98.4,0.0,34496,13247,11094,9189,9189,78,231,466,1508,82,35461,0,23402,11094,78,153,235,1042,64.9,30.8,0.2,0.4,0.7,2.9
W06000004,DENBIGHSHIRE,45948,45773,90.3,8.2,8.2,8.2,8.2,0.8,1.9,4.2,9.3,1.2,95.0,30.5,41501,3756,3756,3756,3756,361,893,1931,4272,538,43641,14032,37745,3756,361,532,1038,2341,82.1,8.2,0.8,1.2,2.3,5.1
E06000015,DERBY,111690,111224,99.1,89.2,88.4,6.9,6.9,0.0,0.0,0.0,0.5,0.4,99.3,0.0,110646,99597,98770,7707,7707,1,2,43,578,466,110863,0,11876,98770,1,1,41,535,10.6,88.4,0.0,0.0,0.0,0.5
E07000035,DERBYSHIRE DALES,33546,33506,88.8,7.9,7.9,7.9,7.9,0.5,1.9,4.2,11.1,1.3,96.6,0.0,29792,2666,2666,2666,2666,165,642,1400,3714,437,32396,0,27126,2666,165,477,758,2314,80.9,7.9,0.5,1.4,2.3,6.9
N09000005,DERRY CITY AND STRABANE,58700,58515,90.8,75.1,75.1,54.7,54.7,2.4,3.7,4.9,8.9,2.7,98.9,0.0,53308,44105,44081,32134,32134,1390,2178,2897,5207,1569,58063,0,9227,44081,1390,788,719,2310,15.7,75.1,2.4,1.3,1.2,3.9
E08000017,DONCASTER,138014,137922,98.0,58.3,58.0,26.0,26.0,0.1,0.3,0.4,1.9,0.1,99.5,14.2,135289,80435,80067,35845,35846,98,346,513,2633,118,137290,19627,55222,80067,98,248,167,2120,40.0,58.0,0.1,0.2,0.1,1.5
E06000059,DORSET,175831,175531,92.5,9.5,8.9,6.2,6.2,0.3,0.9,1.7,7.3,0.6,98.5,7.7,162672,16699,15665,10918,10918,441,1545,2938,12859,1048,173243,13515,147007,15665,441,1104,1393,9921,83.6,8.9,0.3,0.6,0.8,5.6
E07000108,DOVER,52632,52565,93.3,31.9,31.9,4.3,4.3,0.5,1.0,1.8,6.6,0.3,98.8,0.0,49083,16797,16794,2249,2249,284,511,948,3482,153,51982,0,32289,16794,284,227,437,2534,61.3,31.9,0.5,0.4,0.8,4.8
E08000027,DUDLEY,138562,138391,99.3,93.6,92.6,1.9,85.6,0.0,0.0,0.0,0.5,0.1,99.7,4.4,137631,129687,128341,2700,118641,1,11,40,760,169,138124,6037,9290,128341,1,10,29,720,6.7,92.6,0.0,0.0,0.0,0.5
S12000006,DUMFRIES AND GALLOWAY,73862,73393,86.4,6.2,6.2,6.2,6.2,1.6,3.6,6.3,13.0,2.8,97.0,0.0,63802,4564,4564,4564,4564,1170,2676,4629,9591,2042,71619,0,59238,4564,1170,1506,1953,4962,80.2,6.2,1.6,2.0,2.6,6.7
S12000042,DUNDEE CITY,74607,74579,98.8,88.4,86.3,0.9,0.9,0.0,0.0,0.2,1.2,0.0,99.3,0.0,73702,65960,64387,684,684,1,8,159,877,29,74113,0,9315,64387,1,7,151,718,12.5,86.3,0.0,0.0,0.2,1.0
E09000009,EALING,137487,137404,98.8,75.3,73.6,13.0,13.0,0.0,0.0,0.3,1.2,0.1,98.8,0.0,135777,103476,101233,17940,17940,0,20,452,1627,70,135812,0,34544,101233,0,20,432,1175,25.1,73.6,0.0,0.0,0.3,0.9
S12000008,EAST AYRSHIRE,56232,56172,96.6,46.3,45.6,36.3,36.3,0.4,0.8,1.3,3.3,0.3,99.0,0.0,54294,26018,25651,20422,20422,240,437,704,1878,158,55680,0,28643,25651,240,197,267,1174,50.9,45.6,0.4,0.4,0.5,2.1
E07000009,EAST CAMBRIDGESHIRE,37833,37591,94.6,43.0,36.4,13.5,13.5,0.4,0.9,1.5,4.8,0.8,98.8,30.1,35792,16256,13761,5118,5118,165,353,580,1799,284,37386,11377,22031,13761,165,188,227,1219,58.2,36.4,0.4,0.5,0.6,3.2
E07000040,EAST DEVON,69422,69335,87.7,17.5,13.7,10.6,10.6,0.5,2.3,4.7,12.2,0.8,95.8,15.0,60892,12153,9512,7388,7388,328,1590,3289,8443,567,66540,10413,51380,9512,328,1262,1699,5154,74.0,13.7,0.5,1.8,2.4,7.4
S12000045,EAST DUNBARTONSHIRE,47172,47123,97.2,79.2,78.3,18.2,77.5,0.0,0.2,0.4,2.7,0.1,99.1,0.0,45854,37357,36917,8581,36555,14,71,191,1269,59,46755,0,8937,36917,14,57,120,1078,18.9,78.3,0.0,0.1,0.3,2.3
E07000085,EAST HAMPSHIRE,53556,53311,93.1,42.5,38.6,11.1,11.1,0.1,0.5,1.1,6.5,0.8,97.6,0.0,49836,22771,20692,5923,5923,79,269,601,3475,453,52244,0,29144,20692,79,190,332,2874,54.4,38.6,0.1,0.4,0.6,5.4
E07000242,EAST HERTFORDSHIRE,62663,62631,96.1,69.6,66.6,9.4,9.4,0.1,0.4,0.8,3.8,0.3,98.4,0.0,60235,43636,41738,5889,5889,89,239,507,2396,197,61687,0,18497,41738,89,150,268,1889,29.5,66.6,0.1,0.2,0.4,3.0
E07000137,EAST LINDSEY,67606,67266,87.7,19.4,15.6,4.0,4.0,0.9,2.7,4.9,11.8,2.4,97.3,11.1,59293,13124,10563,2696,2696,592,1808,3340,7973,1640,65801,7529,48730,10563,592,1216,1532,4633,72.1,15.6,0.9,1.8,2.3,6.9
S12000010,EAST LOTHIAN,46789,46683,92.9,25.2,24.5,25.2,25.2,0.4,1.4,2.3,6.8,0.4,97.9,41.5,43478,11797,11466,11797,11797,173,640,1076,3205,182,45806,19439,32012,11466,173,467,436,2129,68.4,24.5,0.4,1.0,0.9,4.6
E07000152,EAST NORTHAMPTONSHIRE,40756,40742,98.5,59.0,58.7,12.5,12.5,0.0,0.1,0.3,1.5,0.1,99.2,0.0,40133,24028,23925,5106,5106,16,61,105,609,56,40449,1,16208,23925,16,45,44,504,39.8,58.7,0.0,0.1,0.1,1.2
S12000011,EAST RENFREWSHIRE,39533,39525,96.0,71.1,70.4,7.1,70.3,0.1,0.2,0.5,3.9,0.1,99.0,0.0,37968,28091,27826,2821,27802,27,83,196,1557,32,39149,0,10142,27826,27,56,113,1361,25.7,70.4,0.1,0.1,0.3,3.4
E06000011,EAST RIDING OF YORKSHIRE,156271,155873,96.0,51.2,49.8,48.9,48.9,0.4,0.9,1.4,3.7,0.2,99.0,32.9,150044,80080,77872,76388,76388,652,1366,2115,5829,336,154649,51398,72172,77872,652,714,749,3714,46.2,49.8,0.4,0.5,0.5,2.4
E07000193,EAST STAFFORDSHIRE,52175,52054,94.8,33.3,29.3,24.9,24.9,0.3,0.7,1.4,5.0,0.5,98.8,0.0,49469,17389,15264,12986,12986,143,388,751,2585,260,51544,0,34205,15264,143,245,363,1834,65.6,29.3,0.3,0.5,0.7,3.5
E07000244,EAST SUFFOLK,116625,116460,94.7,19.5,19.4,12.5,12.5,0.1,0.5,1.1,5.2,0.5,99.0,0.0,110392,22697,22659,14610,14610,172,563,1264,6068,601,115414,0,87733,22659,172,391,701,4804,75.2,19.4,0.1,0.3,0.6,4.1
E07000061,EASTBOURNE,47941,47924,99.0,3.1,3.1,3.1,3.1,0.0,0.0,0.0,1.0,0.0,99.7,0.0,47450,1467,1467,1467,1467,1,3,18,474,19,47775,0,45983,1467,1,2,15,456,95.9,3.1,0.0,0.0,0.0,1.0
E07000086,EASTLEIGH,57868,57803,98.0,75.3,65.6,14.0,20.3,0.0,0.0,0.1,1.9,0.1,99.3,0.0,56705,43558,37954,8092,11742,0,0,47,1098,66,57474,0,18751,37954,0,0,47,1051,32.4,65.6,0.0,0.0,0.1,1.8
E07000030,EDEN,26247,26112,83.0,5.1,5.1,5.1,5.1,2.8,5.8,8.7,16.5,2.4,94.9,4.8,21790,1341,1341,1341,1341,740,1534,2275,4322,642,24918,1267,20449,1341,740,794,741,2047,77.9,5.1,2.8,3.0,2.8,7.8
E07000207,ELMBRIDGE,57549,57462,98.9,78.9,76.5,4.5,4.5,0.0,0.0,0.1,0.9,0.1,99.8,0.0,56939,45411,44044,2608,2608,9,20,30,523,83,57435,0,12895,44044,9,11,10,493,22.4,76.5,0.0,0.0,0.0,0.9
E09000010,ENFIELD,124922,124423,98.4,89.7,88.9,2.8,2.8,0.0,0.0,0.2,1.2,0.4,98.7,0.0,122928,112093,111052,3487,3487,16,42,218,1495,541,123290,0,11876,111052,16,26,176,1277,9.5,88.9,0.0,0.0,0.1,1.0
E07000072,EPPING FOREST,56811,56744,95.2,79.7,78.3,11.9,11.9,0.1,0.3,1.0,4.7,0.3,97.1,0.0,54059,45270,44505,6755,6755,42,194,555,2685,196,55141,0,9554,44505,42,152,361,2130,16.8,78.3,0.1,0.3,0.6,3.7
E07000208,EPSOM AND EWELL,31973,31950,99.5,90.7,90.6,60.4,60.4,0.0,0.1,0.2,0.4,0.2,99.7,0.0,31822,29001,28954,19299,19299,0,41,51,128,50,31865,0,2868,28954,0,41,10,77,9.0,90.6,0.0,0.1,0.0,0.2
E07000036,EREWASH,52232,52184,98.4,78.0,76.6,1.0,1.0,0.1,0.1,0.2,1.5,0.1,99.7,0.0,51410,40740,39993,538,538,51,78,111,774,48,52083,0,11417,39993,51,27,33,663,21.9,76.6,0.1,0.1,0.1,1.3
E07000041,EXETER,54024,53968,96.7,88.0,87.8,64.6,64.6,0.0,0.1,1.3,3.2,0.1,97.3,33.0,52252,47531,47439,34904,34904,14,76,715,1716,69,52581,17819,4813,47439,14,62,639,1001,8.9,87.8,0.0,0.1,1.2,1.9
S12000014,FALKIRK,71370,71320,97.4,85.2,85.1,8.4,85.0,0.1,0.4,0.9,2.6,0.2,99.0,0.0,69482,60815,60738,6011,60671,64,283,612,1838,165,70669,0,8744,60738,64,219,329,1226,12.3,85.1,0.1,0.3,0.5,1.7
E07000087,FAREHAM,49873,49830,98.5,87.2,84.7,3.6,3.6,0.0,0.1,0.3,1.4,0.1,99.5,0.0,49138,43480,42255,1802,1815,6,38,159,692,44,49639,0,6883,42255,6,32,121,533,13.8,84.7,0.0,0.1,0.2,1.1
E07000010,FENLAND,45278,45226,94.6,60.2,59.9,30.0,30.0,0.3,0.9,1.4,5.3,0.4,98.7,5.9,42826,27238,27125,13575,13575,157,393,648,2400,191,44668,2677,15701,27125,157,236,255,1752,34.7,59.9,0.3,0.5,0.6,3.9
N09000006,FERMANAGH AND OMAGH,45906,45309,68.0,25.4,25.4,25.4,25.4,8.8,14.5,19.5,30.7,4.8,97.4,40.6,31226,11671,11671,11671,11671,4057,6634,8959,14083,2205,44734,18658,19555,11671,4057,2577,2325,5124,42.6,25.4,8.8,5.6,5.1,11.2
S12000047,FIFE,178693,178483,96.0,53.6,53.1,24.0,24.0,0.2,0.6,1.3,3.8,0.3,99.2,0.0,171607,95847,94955,42919,42919,356,1148,2301,6876,481,177229,0,76652,94955,356,792,1153,4575,42.9,53.1,0.2,0.4,0.6,2.6
W06000005,FLINTSHIRE,69296,69240,94.2,30.7,22.8,18.2,18.2,0.4,1.1,2.4,5.7,0.4,97.9,40.0,65269,21299,15807,12644,12644,284,796,1654,3971,254,67808,27707,49462,15807,284,512,858,2317,71.4,22.8,0.4,0.7,1.2,3.3
E07000112,FOLKESTONE AND HYTHE,51308,51265,93.5,42.4,42.2,5.5,5.5,0.4,1.0,2.1,6.4,0.4,98.1,0.0,47980,21751,21663,2839,2839,180,514,1066,3285,183,50356,0,26317,21663,180,334,552,2219,51.3,42.2,0.4,0.7,1.1,4.3
E07000080,FOREST OF DEAN,38582,38503,80.2,22.2,19.6,17.8,17.8,0.6,3.0,7.6,19.6,2.3,89.3,1.6,30943,8557,7554,6867,6867,213,1164,2931,7560,889,34459,631,23389,7554,213,951,1767,4629,60.6,19.6,0.6,2.5,4.6,12.0
E07000119,FYLDE,34454,34237,93.3,44.1,33.6,5.5,5.5,0.0,0.2,0.8,6.0,0.6,98.1,0.0,32155,15180,11588,1907,1907,16,86,266,2082,218,33790,4,20567,11588,16,70,180,1816,59.7,33.6,0.0,0.2,0.5,5.3
E08000037,GATESHEAD,94533,94275,96.6,73.1,71.8,4.3,4.3,0.0,0.2,0.6,3.1,0.3,98.3,0.0,91339,69101,67902,4111,4111,41,210,542,2936,274,92943,1,23437,67902,41,169,332,2394,24.8,71.8,0.0,0.2,0.4,2.5
E07000173,GEDLING,52801,52725,99.1,89.3,88.5,36.7,36.7,0.0,0.2,0.2,0.8,0.2,99.7,0.0,52308,47175,46718,19383,19383,16,86,117,417,94,52663,0,5590,46718,16,70,31,300,10.6,88.5,0.0,0.1,0.1,0.6
S12000049,GLASGOW CITY,313161,312746,98.3,70.9,65.5,15.4,59.7,0.0,0.1,0.2,1.6,0.1,98.7,0.0,307732,222042,205102,48142,186991,59,157,632,5014,416,308958,0,102630,205102,59,98,475,4382,32.8,65.5,0.0,0.0,0.2,1.4
E07000081,GLOUCESTER,56556,56527,98.8,86.0,85.2,4.7,4.7,0.0,0.0,0.3,1.2,0.1,99.3,0.0,55864,48630,48179,2665,2665,0,9,172,663,42,56139,0,7685,48179,0,9,163,491,13.6,85.2,0.0,0.0,0.3,0.9
E07000088,GOSPORT,37154,37142,99.7,85.9,85.6,1.0,1.0,0.0,0.0,0.0,0.3,0.0,100.0,0.0,37033,31901,31795,364,364,0,6,6,109,12,37136,0,5238,31795,0,6,0,103,14.1,85.6,0.0,0.0,0.0,0.3
E07000109,GRAVESHAM,43122,43074,96.3,71.9,65.8,6.1,6.1,0.0,0.3,0.6,3.6,0.2,98.8,0.0,41526,31025,28372,2648,2648,19,117,243,1548,100,42622,0,13154,28372,19,98,126,1305,30.5,65.8,0.0,0.2,0.3,3.0
E07000145,GREAT YARMOUTH,45582,45427,97.3,52.5,52.5,3.2,3.2,0.0,0.1,0.3,2.4,0.4,99.5,0.0,44338,23939,23932,1467,1467,8,62,145,1089,187,45345,0,20406,23932,8,54,83,944,44.8,52.5,0.0,0.1,0.2,2.1
E09000011,GREENWICH,119617,119560,99.0,82.7,76.4,20.5,20.5,0.0,0.0,0.2,1.0,0.0,99.1,0.0,118389,98950,91333,24577,24577,0,54,200,1171,57,118516,0,27056,91333,0,54,146,971,22.6,76.4,0.0,0.0,0.1,0.8
E07000209,GUILDFORD,55188,55152,96.7,69.1,66.2,2.5,2.5,0.0,0.1,0.5,3.2,0.2,99.5,0.0,53379,38162,36557,1379,1379,14,64,272,1773,95,54888,0,16822,36557,14,50,208,1501,30.5,66.2,0.0,0.1,0.4,2.7
W06000002,GWYNEDD,60863,60584,88.0,18.5,16.9,16.0,16.0,1.3,3.2,5.6,11.6,2.0,94.2,18.6,53533,11287,10295,9716,9716,763,1973,3394,7051,1206,57310,11331,43238,10295,763,1210,1421,3657,71.0,16.9,1.3,2.0,2.3,6.0
E09000012,HACKNEY,113742,113378,97.9,77.5,72.9,19.0,19.0,0.0,0.0,0.2,1.8,0.3,97.9,0.0,111374,88152,82876,21558,21558,0,0,200,2004,362,111383,0,28498,82876,0,0,200,1804,25.1,72.9,0.0,0.0,0.2,1.6
E06000006,HALTON,58537,58366,98.0,68.5,67.7,2.3,3.0,0.0,0.1,0.2,1.7,0.3,99.5,0.0,57382,40098,39656,1328,1758,4,51,126,984,171,58242,0,17726,39656,4,47,75,858,30.3,67.7,0.0,0.1,0.1,1.5
E07000164,HAMBLETON,41407,41308,89.5,7.3,6.6,6.3,6.3,1.4,3.2,5.3,10.3,1.1,97.9,31.8,37056,3027,2714,2592,2592,564,1343,2179,4252,435,40545,13149,34342,2714,564,779,836,2073,82.9,6.6,1.4,1.9,2.0,5.0
E09000013,HAMMERSMITH AND FULHAM,85129,84921,95.6,70.2,58.4,23.9,23.9,0.0,0.0,0.1,4.2,0.2,95.6,0.0,81355,59793,49705,20339,20372,0,1,64,3566,204,81373,0,31650,49705,0,1,63,3502,37.2,58.4,0.0,0.0,0.1,4.1
E07000131,HARBOROUGH,40023,39986,95.3,41.1,35.8,13.2,13.2,0.2,0.5,1.2,4.6,0.4,98.7,0.0,38160,16459,14318,5284,5284,98,215,489,1826,156,39521,0,23842,14318,98,117,274,1337,59.6,35.8,0.2,0.3,0.7,3.3
E09000014,HARINGEY,104393,104314,98.5,84.7,83.3,2.9,2.9,0.0,0.0,0.2,1.4,0.1,98.6,0.0,102877,88410,87004,2987,2987,0,8,242,1437,79,102983,0,15873,87004,0,8,234,1195,15.2,83.3,0.0,0.0,0.2,1.1
E07000073,HARLOW,38982,38827,97.8,92.8,91.8,5.5,5.5,0.0,0.0,0.1,1.8,0.4,97.9,0.0,38115,36168,35794,2160,2160,1,6,22,712,155,38155,0,2321,35794,1,5,16,690,6.0,91.8,0.0,0.0,0.0,1.8
E07000165,HARROGATE,71680,71563,92.5,56.8,54.8,5.3,5.4,0.8,1.9,2.8,7.3,0.7,97.9,6.7,66304,40682,39291,3806,3857,591,1349,1981,5259,528,70188,4780,27013,39291,591,758,632,3278,37.7,54.8,0.8,1.1,0.9,4.6
E09000015,HARROW,93511,93227,98.1,79.7,79.6,14.7,14.7,0.0,0.0,0.4,1.6,0.3,98.2,0.0,91694,74486,74399,13774,13774,14,45,404,1533,307,91806,0,17295,74399,14,31,359,1129,18.5,79.6,0.0,0.0,0.4,1.2
E07000089,HART,42328,42048,95.2,62.4,62.4,8.6,8.6,0.0,0.6,1.0,4.1,0.8,98.5,0.0,40295,26424,26405,3635,3635,18,266,415,1753,338,41688,0,13890,26405,18,248,149,1338,32.8,62.4,0.0,0.6,0.4,3.2
E06000001,HARTLEPOOL,44314,44137,97.6,90.8,90.7,3.2,3.2,0.2,0.4,0.7,2.0,0.4,98.1,0.0,43266,40240,40194,1409,1409,108,167,323,871,184,43485,0,3072,40194,108,59,156,548,6.9,90.7,0.2,0.1,0.4,1.2
E07000062,HASTINGS,43419,43362,98.4,3.4,3.4,3.4,3.4,0.0,0.0,0.0,1.5,0.1,99.9,0.0,42718,1456,1456,1456,1456,0,9,9,644,57,43361,0,41262,1456,0,9,0,635,95.0,3.4,0.0,0.0,0.0,1.5
E07000090,HAVANT,55428,55228,99.0,87.4,87.4,1.2,1.2,0.0,0.0,0.1,0.6,0.4,99.4,0.0,54885,48470,48461,669,669,0,0,71,343,200,55091,0,6424,48461,0,0,71,272,11.6,87.4,0.0,0.0,0.1,0.5
E09000016,HAVERING,107703,106319,96.5,84.5,82.8,4.3,4.3,0.0,0.1,0.3,2.2,1.3,97.2,0.0,103968,90969,89186,4600,4600,39,93,338,2351,1416,104720,0,14782,89186,39,54,245,2013,13.7,82.8,0.0,0.1,0.2,1.9
E06000019,"HEREFORDSHIRE, COUNTY OF",83223,82984,88.1,25.0,20.4,17.3,17.3,1.0,2.9,5.1,11.6,2.0,96.0,3.7,73304,20830,16998,14408,14408,867,2402,4280,9680,1626,79866,3049,56306,16998,867,1535,1878,5400,67.7,20.4,1.0,1.8,2.3,6.5
E07000098,HERTSMERE,44270,44233,98.5,84.9,82.5,6.7,6.7,0.0,0.2,0.3,1.4,0.1,99.3,0.0,43596,37604,36530,2970,2970,3,67,121,637,43,43977,0,7066,36530,3,64,54,516,16.0,82.5,0.0,0.1,0.1,1.2
E07000037,HIGH PEAK,42505,42404,92.2,11.1,7.8,4.1,4.1,0.4,1.0,1.6,7.5,0.6,98.9,0.0,39204,4704,3308,1726,1726,174,427,686,3200,269,42058,0,35896,3308,174,253,259,2514,84.5,7.8,0.4,0.6,0.6,5.9
S12000017,HIGHLAND,105811,104073,81.5,8.7,8.7,8.7,8.7,2.1,4.2,7.3,16.9,3.5,94.2,4.5,86230,9228,9228,9228,9228,2272,4456,7776,17843,3676,99630,4756,77002,9228,2272,2184,3320,10067,72.8,8.7,2.1,2.1,3.1,9.5
E09000017,HILLINGDON,114042,113271,96.9,86.4,85.6,4.3,4.3,0.0,0.2,0.5,2.5,0.7,97.1,0.0,110457,98578,97636,4898,4898,18,181,609,2814,769,110678,0,12821,97636,18,163,428,2205,11.2,85.6,0.0,0.1,0.4,1.9
E07000132,HINCKLEY AND BOSWORTH,51152,50622,95.9,64.7,62.3,7.9,7.9,0.1,0.8,1.2,3.1,1.1,97.7,0.0,49032,33113,31874,4056,4058,31,422,617,1590,555,49989,0,17158,31874,31,391,195,973,33.5,62.3,0.1,0.8,0.4,1.9
E07000227,HORSHAM,62945,62883,93.4,31.1,24.3,18.4,18.4,0.3,1.0,1.8,6.5,0.6,99.0,0.0,58792,19581,15274,11602,11602,178,618,1133,4091,356,62297,0,43518,15274,178,440,515,2958,69.1,24.3,0.3,0.7,0.8,4.7
E09000018,HOUNSLOW,93686,93425,98.5,87.2,87.1,9.8,9.8,0.0,0.0,0.1,1.2,0.3,98.5,0.0,92254,81682,81600,9138,9138,0,16,53,1171,260,92314,0,10654,81600,0,16,37,1118,11.4,87.1,0.0,0.0,0.0,1.2
E07000011,HUNTINGDONSHIRE,78238,77868,96.5,57.8,53.2,5.5,5.5,0.2,0.6,0.9,3.1,0.6,99.1,0.4,75481,45212,41625,4334,4334,176,447,714,2387,452,77514,293,33856,41625,176,271,267,1673,43.3,53.2,0.2,0.3,0.3,2.1
E07000120,HYNDBURN,37399,37217,98.3,72.6,67.6,8.0,8.0,0.0,0.1,0.2,1.2,0.5,99.5,51.2,36751,27139,25295,2987,3006,16,28,79,466,171,37205,19138,11456,25295,16,12,51,387,30.6,67.6,0.0,0.0,0.1,1.0
S12000018,INVERCLYDE,39761,39746,97.5,74.7,74.6,10.1,10.1,0.1,0.3,0.5,2.5,0.2,99.0,0.0,38750,29698,29660,4035,4035,36,103,209,996,63,39374,0,9090,29660,36,67,106,787,22.9,74.6,0.1,0.2,0.3,2.0
E07000202,IPSWICH,61483,61434,98.8,89.0,86.0,3.8,3.8,0.0,0.1,0.3,1.1,0.1,99.0,0.0,60727,54746,52880,2364,2364,0,38,156,707,49,60859,0,7847,52880,0,38,118,551,12.8,86.0,0.0,0.1,0.2,0.9
W06000001,ISLE OF ANGLESEY,34456,34180,88.9,16.4,16.4,16.4,16.4,0.8,2.2,3.9,10.3,2.0,95.5,25.9,30639,5639,5639,5639,5639,283,762,1334,3541,676,32896,8924,25000,5639,283,479,572,2207,72.6,16.4,0.8,1.4,1.7,6.4
E06000046,ISLE OF WIGHT,71858,71645,94.3,27.8,27.8,27.8,27.8,0.2,0.6,1.0,5.5,0.5,99.5,0.0,67727,19976,19976,19976,19976,175,440,752,3918,361,71502,0,47751,19976,175,265,312,3166,66.5,27.8,0.2,0.4,0.4,4.4
E06000053,ISLES OF SCILLY,1112,1111,94.2,0.0,0.0,0.0,0.0,0.0,0.0,0.3,5.7,0.1,99.9,0.0,1048,0,0,0,0,0,0,3,63,1,1111,0,1048,0,0,0,3,60,94.2,0.0,0.0,0.0,0.3,5.4
E09000019,ISLINGTON,105865,105835,96.0,81.6,81.3,16.1,16.1,0.0,0.0,0.0,3.9,0.0,96.0,0.0,101673,86407,86045,17073,17073,0,0,6,4162,30,101674,0,15628,86045,0,0,6,4156,14.8,81.3,0.0,0.0,0.0,3.9
E09000020,KENSINGTON AND CHELSEA,90859,90828,96.4,88.5,85.2,15.7,15.7,0.0,0.0,0.0,3.6,0.0,96.4,0.0,87553,80374,77433,14310,14310,0,0,40,3275,30,87553,0,10120,77433,0,0,40,3235,11.1,85.2,0.0,0.0,0.0,3.6
E07000153,KETTERING,45860,45483,97.8,79.8,74.2,10.9,10.9,0.0,0.3,0.5,1.3,1.0,98.3,0.1,44874,36602,34050,4999,4999,19,149,222,609,463,45097,34,10824,34050,19,130,73,387,23.6,74.2,0.0,0.3,0.2,0.8
E07000146,"KING'S LYNN AND WEST NORFOLK",74050,73677,91.7,10.9,6.5,3.3,3.3,0.4,1.1,2.1,7.8,1.1,98.4,3.1,67919,8038,4803,2464,2464,290,786,1548,5758,783,72835,2273,63116,4803,290,496,762,4210,85.2,6.5,0.4,0.7,1.0,5.7
E06000010,"KINGSTON UPON HULL, CITY OF",120958,119913,99.1,98.1,98.1,98.1,98.1,0.0,0.0,0.0,0.0,0.1,99.1,20.6,119889,118676,118676,118676,118676,0,0,8,24,173,119889,24904,1213,118676,0,0,8,16,1.0,98.1,0.0,0.0,0.0,0.0
E09000021,KINGSTON UPON THAMES,66641,66596,98.7,91.3,87.6,3.7,3.7,0.0,0.0,0.1,1.2,0.1,99.0,0.0,65782,60816,58356,2476,2476,0,2,58,814,45,65943,0,7426,58356,0,2,56,756,11.1,87.6,0.0,0.0,0.1,1.1
E08000034,KIRKLEES,184276,184184,97.3,69.3,69.1,22.6,22.9,0.0,0.2,0.5,2.7,0.1,99.3,0.0,179242,127672,127390,41616,42172,66,303,923,4942,118,182934,0,51852,127390,66,237,620,4019,28.1,69.1,0.0,0.1,0.3,2.2
E08000011,KNOWSLEY,69424,69360,99.0,79.9,79.8,10.2,79.7,0.0,0.1,0.2,0.9,0.1,99.7,0.0,68752,55468,55367,7107,55355,7,87,137,608,75,69229,0,13385,55367,7,80,50,471,19.3,79.8,0.0,0.1,0.1,0.7
E09000022,LAMBETH,144961,144674,96.5,73.4,67.9,11.6,11.6,0.0,0.0,0.0,3.3,0.2,96.7,0.0,139874,106395,98431,16770,16770,0,0,1,4800,257,140111,0,41443,98431,0,0,1,4799,28.6,67.9,0.0,0.0,0.0,3.3
E07000121,LANCASTER,63846,63819,98.4,63.7,53.7,14.5,14.5,0.2,0.3,0.5,1.5,0.1,99.8,0.5,62840,40659,34282,9234,9234,133,181,298,979,67,63738,296,28558,34282,133,48,117,681,44.7,53.7,0.2,0.1,0.2,1.1
E08000035,LEEDS,350982,350839,97.7,86.1,84.1,45.5,82.9,0.0,0.2,0.3,2.2,0.1,98.5,2.0,343067,302071,295313,159597,290880,145,585,1140,7772,224,345840,6936,47754,295313,145,440,555,6632,13.6,84.1,0.0,0.1,0.2,1.9
E06000016,LEICESTER,133324,133277,99.3,91.4,89.8,4.4,4.4,0.0,0.0,0.2,0.7,0.0,99.4,0.0,132352,121919,119785,5850,5850,0,2,212,925,46,132582,0,12567,119785,0,2,210,713,9.4,89.8,0.0,0.0,0.2,0.5
E07000063,LEWES,44564,44535,96.7,25.5,25.3,25.4,25.4,0.1,0.3,0.5,3.3,0.2,99.8,0.0,43074,11350,11260,11325,11325,50,121,230,1461,82,44462,0,31814,11260,50,71,109,1231,71.4,25.3,0.1,0.2,0.2,2.8
E09000023,LEWISHAM,132376,131972,95.4,66.0,62.9,14.2,14.2,0.0,0.0,0.2,4.3,0.3,95.7,0.0,126279,87366,83297,18849,18849,0,0,241,5693,399,126623,0,42982,83297,0,0,241,5452,32.5,62.9,0.0,0.0,0.2,4.1
E07000194,LICHFIELD,46449,46378,96.5,70.2,65.7,6.2,62.8,0.2,0.4,1.0,3.3,0.2,99.6,0.0,44846,32627,30502,2859,29168,113,203,452,1532,93,46263,0,14344,30502,113,90,249,1080,30.9,65.7,0.2,0.2,0.5,2.3
E07000138,LINCOLN,45199,45138,98.9,83.8,83.3,0.6,0.6,0.0,0.1,0.4,1.0,0.1,99.1,24.2,44699,37880,37670,258,258,12,23,163,439,40,44781,10932,7029,37670,12,11,140,276,15.6,83.3,0.0,0.0,0.3,0.6
N09000007,LISBURN AND CASTLEREAGH,57171,57057,93.4,74.4,74.3,57.7,57.7,0.4,1.4,2.3,6.4,0.7,99.1,0.0,53419,42541,42472,32968,32968,222,793,1306,3638,399,56675,0,10947,42472,222,571,513,2332,19.1,74.3,0.4,1.0,0.9,4.1
E08000012,LIVERPOOL,221042,220175,96.1,82.0,79.8,32.4,78.2,0.0,0.0,0.2,3.5,0.4,96.3,0.0,212335,181199,176431,71712,172915,2,33,360,7840,867,212956,0,35904,176431,2,31,327,7480,16.2,79.8,0.0,0.0,0.1,3.4
E06000032,LUTON,81390,81333,99.7,94.9,93.5,2.5,2.5,0.0,0.0,0.0,0.2,0.1,99.7,0.0,81137,77248,76118,2029,2029,1,1,7,196,55,81175,0,5019,76118,1,0,6,189,6.2,93.5,0.0,0.0,0.0,0.2
E07000110,MAIDSTONE,73048,72902,92.9,61.3,55.4,12.0,12.0,0.4,1.4,2.5,6.9,0.7,98.1,0.0,67897,44771,40474,8787,8787,296,1032,1802,5005,534,71656,0,27423,40474,296,736,770,3203,37.5,55.4,0.4,1.0,1.1,4.4
E07000074,MALDON,28083,28024,94.0,18.8,18.8,18.8,18.8,0.3,1.0,1.9,5.8,0.6,99.0,0.0,26394,5275,5275,5275,5275,82,271,534,1630,182,27797,0,21119,5275,82,189,263,1096,75.2,18.8,0.3,0.7,0.9,3.9
E07000235,MALVERN HILLS,35756,35711,89.6,22.8,15.9,11.6,11.6,0.5,2.4,4.4,10.3,1.0,97.6,5.9,32033,8150,5673,4156,4156,196,853,1572,3678,340,34909,2102,26360,5673,196,657,719,2106,73.7,15.9,0.5,1.8,2.0,5.9
E08000003,MANCHESTER,233054,232962,95.9,73.1,69.8,25.1,60.8,0.1,0.1,0.8,4.0,0.0,96.4,0.0,223577,170274,162675,58443,141777,124,313,1976,9385,93,224616,0,60902,162675,124,189,1663,7409,26.1,69.8,0.1,0.1,0.7,3.2
E07000174,MANSFIELD,49644,49624,99.5,90.6,88.4,9.2,9.2,0.0,0.0,0.0,0.5,0.0,99.9,0.0,49374,44994,43902,4560,4560,0,11,20,250,20,49597,0,5472,43902,0,11,9,230,11.0,88.4,0.0,0.0,0.0,0.5
E06000035,MEDWAY,115160,115089,97.9,83.6,80.1,4.5,4.5,0.0,0.2,0.5,2.1,0.1,99.2,0.0,112714,96221,92294,5205,5205,26,247,606,2375,115,114295,0,20420,92294,26,221,359,1769,17.7,80.1,0.0,0.2,0.3,1.5
E07000133,MELTON,23069,23000,94.0,48.4,48.1,2.0,2.0,0.7,1.8,2.8,5.7,1.0,97.3,2.4,21685,11170,11093,469,469,169,423,645,1315,228,22453,556,10592,11093,169,254,222,670,45.9,48.1,0.7,1.1,1.0,2.9
E07000187,MENDIP,52009,51913,84.6,33.7,27.6,5.0,5.0,0.7,2.5,5.7,15.2,1.4,94.5,0.2,44010,17552,14353,2579,2579,355,1292,2941,7903,728,49127,111,29657,14353,355,937,1649,4962,57.0,27.6,0.7,1.8,3.2,9.5
W06000024,MERTHYR TYDFIL,27102,27073,97.1,10.1,10.1,10.1,10.1,0.1,0.2,0.3,2.8,0.1,99.8,10.4,26321,2741,2741,2741,2741,39,67,89,752,35,27049,2823,23580,2741,39,28,22,663,87.0,10.1,0.1,0.1,0.1,2.4
E09000024,MERTON,85212,85184,98.9,88.7,88.2,29.3,29.3,0.0,0.0,0.1,1.1,0.0,98.9,0.0,84261,75562,75177,24944,24944,0,26,51,923,26,84284,0,9084,75177,0,26,25,872,10.7,88.2,0.0,0.0,0.0,1.0
N09000008,MID AND EAST ANTRIM,57617,57373,89.8,60.6,60.3,60.6,60.6,2.1,3.6,4.9,9.7,1.5,98.6,0.0,51767,34929,34721,34928,34928,1229,2079,2833,5606,862,56793,0,17046,34721,1229,850,754,2773,29.6,60.3,2.1,1.5,1.3,4.8
E07000042,MID DEVON,35122,34970,79.4,4.7,4.7,4.7,4.7,1.8,5.8,10.5,20.2,2.9,93.2,12.0,27872,1654,1654,1652,1652,646,2023,3689,7098,1027,32741,4198,26218,1654,646,1377,1666,3409,74.6,4.7,1.8,3.9,4.7,9.7
E07000203,MID SUFFOLK,44951,44839,92.2,14.7,13.5,13.0,13.0,0.4,0.9,1.9,7.6,0.9,98.6,0.0,41444,6611,6084,5833,5833,190,419,854,3395,422,44313,0,35360,6084,190,229,435,2541,78.7,13.5,0.4,0.5,1.0,5.7
E07000228,MID SUSSEX,65666,64931,94.7,29.4,26.0,23.5,23.5,0.0,0.2,0.7,4.1,1.3,98.6,0.0,62206,19273,17087,15453,15453,21,158,446,2725,864,64753,0,45119,17087,21,137,288,2279,68.7,26.0,0.0,0.2,0.4,3.5
N09000009,MID ULSTER,50351,49952,77.0,32.5,32.5,32.5,32.5,4.0,7.3,10.9,22.2,4.8,98.1,4.4,38793,16369,16369,16369,16369,2001,3673,5499,11159,2416,49403,2217,22424,16369,2001,1672,1826,5660,44.5,32.5,4.0,3.3,3.6,11.2
E06000002,MIDDLESBROUGH,63779,63773,97.9,92.4,92.4,2.3,2.3,0.1,0.4,0.5,2.1,0.0,98.2,0.3,62435,58938,58915,1463,1463,61,250,342,1338,5,62604,167,3520,58915,61,189,92,996,5.5,92.4,0.1,0.3,0.1,1.6
S12000019,MIDLOTHIAN,39318,39114,93.6,38.9,38.6,38.9,38.9,0.6,1.5,2.5,5.8,0.8,98.1,5.2,36814,15295,15179,15294,15295,255,588,999,2300,316,38556,2055,21635,15179,255,333,411,1301,55.0,38.6,0.6,0.8,1.0,3.3
E06000042,MILTON KEYNES,114885,114809,98.7,87.9,86.3,84.9,84.9,0.1,0.4,0.6,1.3,0.1,99.3,0.0,113350,100936,99118,97575,97575,66,408,713,1459,165,114118,0,14232,99118,66,342,305,746,12.4,86.3,0.1,0.3,0.3,0.6
E07000210,MOLE VALLEY,37398,37351,95.8,62.1,62.1,10.5,10.5,0.0,0.3,0.7,4.1,0.4,99.4,0.0,35815,23210,23209,3945,3945,16,95,275,1536,149,37163,0,12606,23209,16,79,180,1261,33.7,62.1,0.0,0.2,0.5,3.4
W06000021,MONMOUTHSHIRE,41528,41349,87.3,25.2,15.5,8.9,8.9,1.4,3.1,5.8,12.3,2.4,96.3,0.2,36256,10452,6453,3692,3692,575,1304,2391,5093,1014,40000,66,29803,6453,575,729,1087,2702,71.8,15.5,1.4,1.8,2.6,6.5
S12000020,MORAY,45539,45257,84.9,10.1,10.1,10.1,10.1,1.6,4.4,6.8,14.5,3.1,95.8,0.0,38667,4619,4619,4619,4619,707,1992,3095,6590,1422,43642,0,34048,4619,707,1285,1103,3495,74.8,10.1,1.6,2.8,2.4,7.7
S12000013,NA H-EILEANAN SIAR,15243,13996,75.1,3.9,3.9,3.9,3.9,2.8,4.2,5.5,16.7,10.5,88.5,0.0,11447,592,592,592,592,420,640,836,2549,1604,13497,0,10855,592,420,220,196,1713,71.2,3.9,2.8,1.4,1.3,11.2
W06000012,NEATH PORT TALBOT,65359,65328,97.5,59.5,59.5,2.9,2.9,0.0,0.1,0.2,2.4,0.1,99.6,35.8,63730,38881,38877,1896,1896,21,55,134,1598,78,65102,23415,24853,38877,21,34,79,1464,38.0,59.5,0.0,0.1,0.1,2.2
E07000091,NEW FOREST,82101,81954,93.2,27.0,20.6,10.3,10.4,0.5,0.8,1.4,6.6,0.8,99.0,0.0,76502,22207,16923,8485,8513,384,651,1188,5452,674,81247,0,59579,16923,384,267,537,4264,72.6,20.6,0.5,0.3,0.7,5.2
E07000175,NEWARK AND SHERWOOD,54936,54717,96.2,55.4,55.2,13.1,13.1,0.2,0.8,1.2,3.4,0.6,98.7,0.0,52861,30444,30338,7181,7181,129,440,645,1856,311,54245,8,22523,30338,129,311,205,1211,41.0,55.2,0.2,0.6,0.4,2.2
E08000021,NEWCASTLE UPON TYNE,137503,137199,96.3,71.4,66.2,19.7,19.7,0.0,0.0,0.1,3.5,0.2,97.0,0.0,132365,98220,91002,27068,27085,10,60,157,4834,304,133315,0,41363,91002,10,50,97,4677,30.1,66.2,0.0,0.0,0.1,3.4
E07000195,NEWCASTLE-UNDER-LYME,57322,56839,96.2,68.3,66.2,12.1,12.1,0.0,0.2,0.6,2.9,0.9,98.7,2.2,55168,39128,37948,6956,6956,18,136,324,1671,527,56551,1241,17220,37948,18,118,188,1347,30.0,66.2,0.0,0.2,0.3,2.3
E09000025,NEWHAM,119671,119463,98.5,87.1,82.7,19.2,19.2,0.0,0.0,0.4,1.4,0.2,98.5,0.0,117844,104239,98981,23015,23015,1,50,432,1619,208,117859,0,18863,98981,1,49,382,1187,15.8,82.7,0.0,0.0,0.3,1.0
W06000022,NEWPORT,67864,67825,97.9,74.0,70.9,7.4,7.4,0.0,0.2,0.5,2.0,0.1,98.7,34.5,66457,50251,48138,5048,5048,29,123,359,1368,48,66981,23437,18319,48138,29,94,236,1009,27.0,70.9,0.0,0.1,0.3,1.5
N09000010,"NEWRY, MOURNE AND DOWN",65291,64377,82.6,34.7,34.7,34.7,34.7,3.0,5.6,7.9,16.0,3.7,97.9,3.4,53948,22635,22635,22635,22635,1969,3650,5136,10429,2402,63922,2204,31313,22635,1969,1681,1486,5293,48.0,34.7,3.0,2.6,2.3,8.1
S12000021,NORTH AYRSHIRE,68181,68118,94.3,30.7,30.7,9.7,9.7,0.4,0.8,1.7,5.6,0.4,99.1,0.0,64313,20947,20941,6636,6636,286,559,1129,3805,251,67568,0,43372,20941,286,273,570,2676,63.6,30.7,0.4,0.4,0.8,3.9
E07000043,NORTH DEVON,45850,45737,87.6,4.9,4.9,4.9,4.9,1.3,3.1,5.9,12.2,1.3,94.6,56.0,40157,2266,2266,2266,2266,582,1419,2695,5580,616,43390,25675,37891,2266,582,837,1276,2885,82.6,4.9,1.3,1.8,2.8,6.3
E07000038,NORTH EAST DERBYSHIRE,46281,46230,93.2,25.7,24.1,22.1,22.1,0.3,0.8,1.3,6.7,0.2,99.3,0.0,43152,11879,11160,10222,10222,125,357,582,3078,96,45959,0,31992,11160,125,232,225,2496,69.1,24.1,0.3,0.5,0.5,5.4
E06000012,NORTH EAST LINCOLNSHIRE,69591,69542,98.0,91.2,91.1,0.7,0.7,0.1,0.7,0.9,1.9,0.2,98.8,26.1,68218,63489,63409,491,491,48,480,611,1324,136,68744,18198,4809,63409,48,432,131,713,6.9,91.1,0.1,0.6,0.2,1.0
E07000099,NORTH HERTFORDSHIRE,57801,57748,96.2,66.8,65.5,2.4,2.4,0.1,0.4,0.9,3.7,0.3,98.7,0.0,55617,38602,37878,1394,1394,47,203,519,2131,174,57054,0,17739,37878,47,156,316,1612,30.7,65.5,0.1,0.3,0.5,2.8
E07000139,NORTH KESTEVEN,51557,51468,94.1,37.1,35.8,3.9,3.9,0.7,1.3,2.0,5.7,0.5,98.3,4.8,48527,19125,18450,2028,2028,336,679,1024,2941,260,50668,2485,30077,18450,336,343,345,1917,58.3,35.8,0.7,0.7,0.7,3.7
S12000050,NORTH LANARKSHIRE,157797,157699,98.3,77.4,76.4,10.0,76.3,0.0,0.1,0.3,1.6,0.1,99.5,0.0,155180,122080,120547,15716,120331,69,227,528,2519,202,157025,0,34633,120547,69,158,301,1991,21.9,76.4,0.0,0.1,0.2,1.3
E06000013,NORTH LINCOLNSHIRE,75214,75104,95.0,47.2,47.2,6.1,6.1,0.4,0.8,1.2,4.9,0.2,98.4,52.5,71425,35491,35489,4568,4568,312,580,938,3679,180,74001,39458,35936,35489,312,268,358,2741,47.8,47.2,0.4,0.4,0.5,3.6
E07000147,NORTH NORFOLK,54022,53924,91.2,4.4,4.4,4.4,4.4,0.4,1.4,2.6,8.7,1.8,97.9,0.1,49245,2363,2363,2357,2357,241,777,1394,4679,946,52861,60,46882,2363,241,536,617,3285,86.8,4.4,0.4,1.0,1.1,6.1
E06000024,NORTH SOMERSET,97742,96723,91.4,48.4,41.3,17.4,17.4,0.3,0.8,1.7,7.5,1.2,96.0,0.0,89384,47314,40366,17006,17006,269,735,1705,7339,1158,93861,0,49018,40366,269,466,970,5634,50.2,41.3,0.3,0.5,1.0,5.8
E08000022,NORTH TYNESIDE,98207,98023,98.5,67.3,64.6,3.9,3.9,0.0,0.1,0.3,1.3,0.2,99.4,0.0,96752,66079,63455,3853,3853,3,51,254,1271,215,97650,0,33297,63455,3,48,203,1017,33.9,64.6,0.0,0.0,0.2,1.0
E07000218,NORTH WARWICKSHIRE,28311,28289,96.5,26.5,24.7,9.4,23.3,0.2,0.8,1.2,3.4,0.1,99.6,0.0,27326,7506,6990,2673,6585,55,221,339,963,37,28190,0,20336,6990,55,166,118,624,71.8,24.7,0.2,0.6,0.4,2.2
E07000134,NORTH WEST LEICESTERSHIRE,45184,45146,96.5,68.9,67.4,3.1,3.1,0.1,0.7,1.0,3.5,0.4,99.4,0.0,43582,31116,30437,1407,1407,59,315,471,1564,167,44930,0,13145,30437,59,256,156,1093,29.1,67.4,0.1,0.6,0.3,2.4
E07000154,NORTHAMPTON,100326,98161,97.3,86.8,84.9,12.4,12.4,0.0,0.0,0.1,0.6,2.2,97.4,1.2,97571,87092,85168,12393,12394,0,19,58,590,2164,97753,1252,12403,85168,0,19,39,532,12.4,84.9,0.0,0.0,0.0,0.5
E06000057,NORTHUMBERLAND,144659,144440,93.2,14.6,9.1,5.7,5.7,0.8,1.5,2.2,6.6,0.7,98.9,5.4,134894,21107,13217,8276,8276,1139,2217,3209,9546,1013,143123,7871,121677,13217,1139,1078,992,6337,84.1,9.1,0.8,0.7,0.7,4.4
E07000148,NORWICH,53594,53583,99.1,87.9,85.4,0.2,0.2,0.0,0.0,0.4,0.9,0.0,99.3,0.0,53091,47116,45771,130,130,0,2,213,492,11,53241,0,7320,45771,0,2,211,279,13.7,85.4,0.0,0.0,0.4,0.5
E06000018,NOTTINGHAM,135184,135132,98.6,93.2,92.1,20.2,20.2,0.0,0.0,0.2,1.4,0.0,98.7,0.0,133257,126020,124476,27366,27366,3,47,207,1875,48,133454,0,8781,124476,3,44,160,1668,6.5,92.1,0.0,0.0,0.1,1.2
E07000219,NUNEATON AND BEDWORTH,57142,57130,99.4,80.3,80.3,6.1,80.3,0.0,0.0,0.1,0.6,0.0,99.9,0.0,56781,45863,45860,3458,45860,4,25,43,349,17,57080,0,10921,45860,4,21,18,306,19.1,80.3,0.0,0.0,0.0,0.5
E07000135,OADBY AND WIGSTON,24078,24026,98.8,79.2,76.6,1.1,1.1,0.0,0.0,0.1,1.0,0.2,99.2,0.0,23790,19060,18439,259,259,0,3,16,236,51,23881,0,5351,18439,0,3,13,220,22.2,76.6,0.0,0.0,0.1,0.9
E08000004,OLDHAM,93139,93018,98.3,78.7,78.5,14.7,14.9,0.1,0.2,0.3,1.6,0.1,99.6,0.0,91568,73344,73080,13688,13877,67,143,282,1450,120,92802,0,18488,73080,67,76,139,1168,19.8,78.5,0.1,0.1,0.1,1.3
S12000023,ORKNEY ISLANDS,11765,11261,64.0,1.1,1.1,1.1,1.1,4.1,9.8,20.8,31.7,7.2,76.5,0.0,7531,128,128,128,128,485,1158,2446,3730,849,8997,0,7403,128,485,673,1288,1284,62.9,1.1,4.1,5.7,10.9,10.9
E07000178,OXFORD,61720,61630,97.9,87.0,82.7,1.5,1.5,0.0,0.0,0.3,2.0,0.1,98.0,0.0,60413,53726,51058,909,909,0,23,161,1217,90,60483,0,9355,51058,0,23,138,1056,15.2,82.7,0.0,0.0,0.2,1.7
W06000009,PEMBROKESHIRE,59805,59702,88.0,6.4,6.4,6.4,6.4,1.6,3.8,6.5,11.8,2.1,95.3,5.3,52637,3851,3851,3849,3849,983,2288,3877,7065,1228,56973,3185,48786,3851,983,1305,1589,3188,81.6,6.4,1.6,2.2,2.7,5.3
E07000122,PENDLE,40435,40362,96.4,53.8,53.4,1.5,53.0,0.4,0.9,1.3,3.5,0.3,99.2,4.3,38961,21758,21610,601,21420,163,372,514,1401,134,40093,1757,17351,21610,163,209,142,887,42.9,53.4,0.4,0.5,0.4,2.2
S12000048,PERTH AND KINROSS,72892,72469,85.7,35.6,34.8,4.8,4.8,1.6,3.9,6.9,13.8,2.2,95.7,0.0,62433,25931,25390,3524,3524,1131,2855,5060,10036,1603,69724,0,37043,25390,1131,1724,2205,4976,50.8,34.8,1.6,2.4,3.0,6.8
E06000031,PETERBOROUGH,86470,86417,98.2,82.3,81.7,48.2,48.2,0.0,0.2,0.3,1.8,0.1,99.0,0.0,84879,71152,70661,41709,41709,41,143,239,1538,90,85625,0,14218,70661,41,102,96,1299,16.4,81.7,0.0,0.1,0.1,1.5
E06000026,PLYMOUTH,120304,119927,97.1,88.8,87.0,2.9,2.9,0.0,0.1,0.7,2.5,0.3,97.6,27.0,116873,106795,104671,3440,3440,2,110,813,3054,384,117361,32424,12202,104671,2,108,703,2241,10.1,87.0,0.0,0.1,0.6,1.9
E06000044,PORTSMOUTH,90584,90463,98.0,94.3,92.3,4.9,4.9,0.0,0.1,0.3,1.9,0.1,98.0,0.0,88733,85400,83652,4465,4465,0,88,310,1730,121,88797,0,5081,83652,0,88,222,1420,5.6,92.3,0.0,0.1,0.2,1.6
W06000023,POWYS,63210,62225,77.4,16.7,16.7,16.7,16.7,3.4,7.4,12.4,21.0,5.8,88.4,7.4,48930,10537,10536,10534,10534,2168,4706,7861,13295,3676,55868,4706,38394,10536,2168,2538,3155,5434,60.7,16.7,3.4,4.0,5.0,8.6
E07000123,PRESTON,62514,62339,97.7,73.7,72.0,5.9,5.9,0.0,0.1,0.4,2.0,0.4,99.0,34.1,61088,46102,45011,3705,3705,25,48,269,1251,260,61903,21319,16077,45011,25,23,221,982,25.7,72.0,0.0,0.0,0.4,1.6
E06000038,READING,71268,71164,98.7,89.5,86.0,7.1,82.8,0.0,0.0,0.1,1.2,0.1,98.9,0.0,70311,63774,61317,5071,59008,1,16,39,853,104,70464,0,8994,61317,1,15,23,814,12.6,86.0,0.0,0.0,0.0,1.1
E09000026,REDBRIDGE,105539,105386,97.5,84.0,83.2,28.0,28.0,0.0,0.0,0.2,2.4,0.1,98.0,0.0,102890,88606,87771,29536,29536,1,35,204,2496,144,103391,0,15119,87771,1,34,169,2292,14.3,83.2,0.0,0.0,0.2,2.2
E06000003,REDCAR AND CLEVELAND,64442,64421,97.3,87.9,87.1,1.1,1.1,0.1,0.4,1.0,2.7,0.1,98.4,0.4,62698,56635,56147,691,691,39,275,639,1723,68,63418,236,6551,56147,39,236,364,1084,10.2,87.1,0.1,0.4,0.6,1.7
E07000236,REDDITCH,36722,36698,98.2,81.9,81.8,2.0,81.9,0.0,0.0,0.1,1.8,0.1,99.1,0.1,36045,30064,30053,727,30059,1,7,24,653,25,36407,26,5992,30053,1,6,17,629,16.3,81.8,0.0,0.0,0.0,1.7
E07000211,REIGATE AND BANSTEAD,61250,61215,97.7,75.1,74.3,20.1,20.1,0.0,0.1,0.2,2.2,0.1,99.8,0.0,59858,46014,45513,12334,12334,11,70,130,1357,65,61111,0,14345,45513,11,59,60,1227,23.4,74.3,0.0,0.1,0.1,2.0
S12000038,RENFREWSHIRE,88679,88665,97.1,75.8,75.8,11.4,44.9,0.1,0.2,0.5,2.9,0.0,98.8,0.0,86075,67250,67203,10125,39850,95,209,407,2590,43,87625,0,18872,67203,95,114,198,2183,21.3,75.8,0.1,0.1,0.2,2.5
W06000016,RHONDDA CYNON TAF,110604,110333,97.7,21.3,16.9,6.7,6.7,0.0,0.1,0.4,2.0,0.4,99.3,26.9,108090,23544,18678,7411,7411,33,64,413,2243,418,109838,29752,89412,18678,33,31,349,1830,80.8,16.9,0.0,0.0,0.3,1.7
E07000124,RIBBLE VALLEY,27940,27909,90.8,22.8,22.5,21.7,21.7,0.8,2.1,3.6,9.0,0.7,98.9,52.1,25382,6370,6297,6056,6059,214,591,1011,2527,182,27639,14547,19085,6297,214,377,420,1516,68.3,22.5,0.8,1.3,1.5,5.4
E09000027,RICHMOND UPON THAMES,83649,83550,98.8,88.0,86.0,15.9,15.9,0.0,0.0,0.2,1.1,0.1,98.9,0.0,82618,73594,71929,13289,13289,0,9,171,932,100,82729,0,10689,71929,0,9,162,761,12.8,86.0,0.0,0.0,0.2,0.9
E07000166,RICHMONDSHIRE,22655,22590,84.6,23.5,12.4,5.0,5.0,2.3,4.6,7.9,15.1,2.6,96.6,35.4,19169,5323,2806,1141,1141,531,1043,1787,3421,596,21891,8029,16363,2806,531,512,744,1634,72.2,12.4,2.3,2.3,3.3,7.2
E08000005,ROCHDALE,95348,95262,97.9,71.8,65.3,10.6,10.6,0.0,0.1,0.4,2.0,0.1,99.4,0.0,93348,68460,62234,10104,10112,15,79,338,1914,109,94778,0,31114,62234,15,64,259,1576,32.6,65.3,0.0,0.1,0.3,1.7
E07000075,ROCHFORD,36261,36137,97.2,16.7,11.9,7.7,7.7,0.0,0.1,0.3,2.4,0.3,99.4,0.0,35250,6066,4322,2788,2788,1,35,111,887,103,36028,0,30928,4322,1,34,76,776,85.3,11.9,0.0,0.1,0.2,2.1
E07000125,ROSSENDALE,32265,32105,94.3,53.4,43.8,1.4,1.4,0.1,0.7,1.0,5.2,0.6,98.9,0.0,30423,17230,14130,436,436,28,228,308,1682,200,31920,11,16293,14130,28,200,80,1374,50.5,43.8,0.1,0.6,0.2,4.3
E07000064,ROTHER,45177,45114,93.5,4.8,4.8,4.8,4.8,0.1,0.4,1.3,6.4,0.3,99.5,0.0,42233,2187,2187,2187,2187,43,166,573,2881,148,44964,0,40046,2187,43,123,407,2308,88.6,4.8,0.1,0.3,0.9,5.1
E08000018,ROTHERHAM,117468,117424,98.7,62.8,60.5,9.0,9.0,0.0,0.0,0.1,1.3,0.1,99.8,0.4,115946,73780,71069,10594,10596,19,58,167,1478,85,117288,478,44877,71069,19,39,109,1311,38.2,60.5,0.0,0.0,0.1,1.1
E07000220,RUGBY,47663,47590,97.3,68.4,64.8,14.2,61.4,0.2,0.4,0.7,2.5,0.3,99.0,0.0,46385,32598,30892,6760,29285,103,201,334,1205,122,47200,0,15493,30892,103,98,133,871,32.5,64.8,0.2,0.2,0.3,1.8
E07000212,RUNNYMEDE,36251,36214,96.7,71.7,69.2,3.0,3.0,0.0,0.0,0.6,3.2,0.1,98.5,0.0,35061,25983,25092,1104,1104,0,8,226,1153,45,35721,0,9969,25092,0,8,218,927,27.5,69.2,0.0,0.0,0.6,2.6
E07000176,RUSHCLIFFE,51268,51221,97.7,76.3,73.0,20.5,20.5,0.1,0.3,0.6,2.2,0.2,99.6,0.5,50073,39114,37451,10502,10502,58,147,319,1148,92,51069,239,12622,37451,58,89,172,829,24.6,73.0,0.1,0.2,0.3,1.6
E07000092,RUSHMOOR,40392,40365,97.9,83.2,83.1,4.2,4.2,0.1,0.8,1.3,2.1,0.2,98.0,0.0,39536,33594,33552,1683,1683,47,313,519,829,62,39600,0,5984,33552,47,266,206,310,14.8,83.1,0.1,0.7,0.5,0.8
E06000017,RUTLAND,17097,17069,92.1,12.1,12.1,12.1,12.1,0.1,0.3,0.6,7.8,0.3,99.4,0.0,15742,2067,2067,2067,2067,21,54,98,1327,48,16996,0,13675,2067,21,33,44,1229,80.0,12.1,0.1,0.2,0.3,7.2
E07000167,RYEDALE,26637,26325,84.6,7.9,7.9,7.9,7.9,2.9,5.4,8.0,14.3,3.0,94.9,18.2,22526,2117,2117,2117,2117,776,1445,2136,3799,802,25270,4860,20409,2117,776,669,691,1663,76.6,7.9,2.9,2.5,2.6,6.2
E08000006,SALFORD,121034,120989,96.8,84.2,83.9,58.0,83.5,0.0,0.6,1.6,3.1,0.0,97.0,0.0,117200,101951,101568,70177,101079,4,749,1932,3789,49,117367,0,15632,101568,4,745,1183,1857,12.9,83.9,0.0,0.6,1.0,1.5
E08000028,SANDWELL,132340,132288,99.6,84.3,82.8,11.5,72.5,0.0,0.0,0.1,0.3,0.0,99.7,0.0,131872,111606,109624,15236,96010,3,10,172,416,50,132006,0,22248,109624,3,7,162,244,16.8,82.8,0.0,0.0,0.1,0.2
E07000168,SCARBOROUGH,56137,56073,94.0,2.6,2.6,2.6,2.6,0.5,1.1,1.7,5.9,0.6,98.3,1.7,52775,1450,1450,1448,1448,297,638,973,3298,320,55187,962,51325,1450,297,341,335,2325,91.4,2.6,0.5,0.6,0.6,4.1
S12000026,SCOTTISH BORDERS,56783,56270,86.1,14.4,11.4,9.3,9.3,1.6,4.0,7.0,13.0,3.1,95.5,15.0,48913,8186,6478,5298,5298,928,2279,3947,7357,1733,54222,8516,42435,6478,928,1351,1668,3410,74.7,11.4,1.6,2.4,2.9,6.0
E07000188,SEDGEMOOR,55002,54954,91.7,26.3,13.7,6.3,6.3,0.4,1.5,2.7,8.2,0.8,97.0,0.0,50446,14474,7515,3440,3440,227,804,1507,4508,435,53330,0,42931,7515,227,577,703,3001,78.1,13.7,0.4,1.0,1.3,5.5
E08000014,SEFTON,127259,127017,98.5,71.7,66.4,27.1,61.8,0.0,0.1,0.2,1.3,0.2,99.6,0.0,125326,91301,84553,34452,78674,46,113,195,1691,247,126748,0,40773,84553,46,67,82,1496,32.0,66.4,0.0,0.1,0.1,1.2
E07000169,SELBY,40094,39937,92.4,19.4,19.4,19.4,19.4,0.6,1.1,1.8,7.2,0.7,98.0,14.1,37056,7777,7777,7775,7776,233,441,733,2881,279,39310,5654,29279,7777,233,208,292,2148,73.0,19.4,0.6,0.5,0.7,5.4
E07000111,SEVENOAKS,50387,50344,92.6,40.2,39.9,15.0,15.0,0.2,0.5,1.2,7.3,0.3,99.6,0.0,46682,20255,20083,7548,7548,97,267,601,3662,168,50168,0,26599,20083,97,170,334,3061,52.8,39.9,0.2,0.3,0.7,6.1
E08000019,SHEFFIELD,246041,245725,96.8,50.2,46.5,4.4,4.4,0.0,0.0,0.3,3.1,0.1,98.0,0.1,238183,123432,114434,10917,10917,52,122,781,7542,361,241119,287,123749,114434,52,70,659,6761,50.3,46.5,0.0,0.0,0.3,2.7
S12000027,SHETLAND ISLANDS,10485,10231,70.5,2.0,2.0,2.0,2.0,3.1,7.2,16.7,27.1,5.5,84.7,0.0,7389,211,211,211,211,326,754,1751,2842,576,8880,0,7178,211,326,428,997,1091,68.5,2.0,3.1,4.1,9.5,10.4
E06000051,SHROPSHIRE,142798,142291,86.8,20.3,14.0,6.7,6.7,0.9,3.0,5.8,12.8,0.9,96.2,78.2,123949,28986,20021,9573,9573,1355,4310,8296,18342,1293,137331,111678,103928,20021,1355,2955,3986,10046,72.8,14.0,0.9,2.1,2.8,7.0
E06000039,SLOUGH,54562,54475,99.3,91.5,87.8,14.8,14.8,0.0,0.0,0.1,0.5,0.2,99.6,0.0,54201,49925,47879,8061,8061,2,6,34,274,87,54320,0,6322,47879,2,4,28,240,11.6,87.8,0.0,0.0,0.1,0.4
E08000029,SOLIHULL,92620,92549,98.1,87.3,86.4,21.9,85.7,0.0,0.1,0.7,1.9,0.1,98.7,0.0,90828,80841,80060,20322,79356,12,91,679,1721,75,91424,1,10768,80060,12,79,588,1042,11.6,86.4,0.0,0.1,0.6,1.1
E07000246,SOMERSET WEST AND TAUNTON,71858,71680,89.0,23.3,13.3,5.6,5.6,0.8,2.6,4.9,10.8,1.5,96.2,5.4,63954,16731,9549,4024,4024,595,1866,3488,7726,1072,69111,3909,54405,9549,595,1271,1622,4238,75.7,13.3,0.8,1.8,2.3,5.9
S12000028,SOUTH AYRSHIRE,55649,55581,94.2,59.0,57.8,1.1,1.1,0.4,1.2,2.5,5.7,0.9,98.6,0.0,52426,32840,32174,585,585,195,679,1391,3155,495,54844,0,20252,32174,195,484,712,1764,36.4,57.8,0.4,0.9,1.3,3.2
E07000012,SOUTH CAMBRIDGESHIRE,66901,66831,96.3,57.3,55.3,15.5,15.5,0.1,0.3,0.9,3.6,0.2,99.0,0.7,64403,38320,37007,10368,10368,95,218,614,2428,142,66232,447,27396,37007,95,123,396,1814,41.0,55.3,0.1,0.2,0.6,2.7
E07000039,SOUTH DERBYSHIRE,45884,45745,94.4,32.8,27.5,17.4,17.4,0.2,1.0,1.4,5.3,0.5,98.8,0.0,43306,15056,12627,7964,7964,85,458,635,2439,251,45351,0,30679,12627,85,373,177,1804,66.9,27.5,0.2,0.8,0.4,3.9
E06000025,SOUTH GLOUCESTERSHIRE,119749,119613,98.5,80.3,79.9,11.9,11.9,0.1,0.2,0.4,1.3,0.2,99.6,0.0,117997,96195,95654,14209,14258,82,190,470,1616,212,119315,0,22343,95654,82,108,280,1146,18.7,79.9,0.1,0.1,0.2,1.0
E07000044,SOUTH HAMS,42773,42700,82.5,23.7,22.9,19.2,19.2,0.7,2.6,6.9,17.3,2.0,94.7,33.3,35308,10126,9797,8219,8219,316,1120,2946,7392,837,40515,14255,25511,9797,316,804,1826,4446,59.6,22.9,0.7,1.9,4.3,10.4
E07000140,SOUTH HOLLAND,41308,41244,88.6,11.9,8.5,6.6,6.6,0.4,1.6,3.1,11.2,1.0,99.0,0.5,36615,4918,3518,2721,2721,176,675,1286,4629,424,40888,218,33097,3518,176,499,611,3343,80.1,8.5,0.4,1.2,1.5,8.1
E07000141,SOUTH KESTEVEN,64401,64354,94.0,33.6,31.8,4.5,4.5,0.7,1.0,1.6,5.9,0.3,99.0,0.0,60553,21624,20478,2875,2875,428,666,1025,3801,164,63753,0,40075,20478,428,238,359,2776,62.2,31.8,0.7,0.4,0.6,4.3
E07000031,SOUTH LAKELAND,53071,53008,93.3,13.1,11.5,10.3,10.3,0.4,1.0,1.8,6.6,0.8,98.8,39.5,49521,6972,6099,5492,5492,201,509,969,3487,450,52419,20972,43422,6099,201,308,460,2518,81.8,11.5,0.4,0.6,0.9,4.7
S12000029,SOUTH LANARKSHIRE,153369,152705,95.5,66.9,66.5,11.2,66.2,0.4,1.0,2.0,4.1,0.7,98.6,0.0,146442,102642,101979,17122,101472,622,1596,3001,6263,1148,151181,0,44463,101979,622,974,1405,3262,29.0,66.5,0.4,0.6,0.9,2.1
E07000149,SOUTH NORFOLK,62165,62086,91.2,14.4,13.3,8.5,8.5,0.4,1.3,2.5,8.7,1.2,98.6,0.0,56693,8968,8299,5268,5268,230,785,1552,5393,772,61291,0,48394,8299,230,555,767,3841,77.8,13.3,0.4,0.9,1.2,6.2
E07000155,SOUTH NORTHAMPTONSHIRE,40181,40085,94.2,33.1,25.1,20.2,20.2,0.2,1.8,2.5,5.6,0.8,97.0,0.6,37845,13291,10086,8102,8102,64,732,1020,2240,312,38969,260,27759,10086,64,668,288,1220,69.1,25.1,0.2,1.7,0.7,3.0
E07000179,SOUTH OXFORDSHIRE,62455,62185,96.3,51.9,46.9,23.7,23.7,0.1,0.3,0.6,3.3,0.6,99.4,0.0,60133,32430,29293,14832,14833,63,175,353,2052,346,62099,0,30840,29293,63,112,178,1699,49.4,46.9,0.1,0.2,0.3,2.7
E07000126,SOUTH RIBBLE,49971,49932,96.7,69.0,67.7,5.0,5.0,0.1,0.4,0.8,3.2,0.1,99.2,7.1,48344,34497,33807,2505,2505,26,178,388,1588,39,49561,3560,14537,33807,26,152,210,1200,29.1,67.7,0.1,0.3,0.4,2.4
E07000189,SOUTH SOMERSET,78470,78063,88.5,3.5,3.1,3.0,3.0,0.5,2.4,4.3,11.0,1.3,97.0,4.3,69465,2708,2453,2365,2365,395,1866,3346,8598,990,76128,3385,67012,2453,395,1471,1480,5252,85.4,3.1,0.5,1.9,1.9,6.7
E07000196,SOUTH STAFFORDSHIRE,47217,47162,93.1,36.9,32.3,29.4,29.6,0.2,0.7,1.7,6.8,0.2,98.6,5.4,43939,17418,15247,13885,13956,95,321,802,3223,83,46541,2566,28692,15247,95,226,481,2421,60.8,32.3,0.2,0.5,1.0,5.1
E08000023,SOUTH TYNESIDE,72135,72122,98.2,77.8,77.3,1.0,1.0,0.1,0.2,0.3,1.7,0.0,99.3,0.0,70872,56122,55737,755,755,41,117,233,1250,13,71666,0,15135,55737,41,76,116,1017,21.0,77.3,0.1,0.1,0.2,1.4
E06000045,SOUTHAMPTON,107749,107318,96.6,90.4,86.5,8.1,78.9,0.0,0.0,0.5,3.0,0.4,96.8,0.0,104064,97379,93186,8753,85059,0,13,567,3254,431,104331,0,10878,93186,0,13,554,2687,10.1,86.5,0.0,0.0,0.5,2.5
E06000033,SOUTHEND-ON-SEA,81624,81502,97.3,73.9,68.0,21.3,21.3,0.0,0.0,0.0,2.5,0.1,97.7,0.0,79438,60289,55515,17357,17357,0,0,5,2064,122,79775,0,23923,55515,0,0,5,2059,29.3,68.0,0.0,0.0,0.0,2.5
E09000028,SOUTHWARK,138432,138280,94.6,79.1,78.1,46.2,46.2,0.0,0.0,0.3,5.3,0.1,94.7,0.0,130975,109568,108139,63987,63987,0,5,396,7305,150,131028,0,22836,108139,0,5,391,6909,16.5,78.1,0.0,0.0,0.3,5.0
E07000213,SPELTHORNE,42871,42744,97.4,85.6,84.3,23.5,23.5,0.0,0.0,0.6,2.3,0.3,97.9,0.0,41750,36693,36136,10055,10055,0,7,268,994,127,41975,0,5614,36136,0,7,261,726,13.1,84.3,0.0,0.0,0.6,1.7
E07000240,ST ALBANS,61358,61290,97.6,86.7,84.8,24.1,24.1,0.0,0.1,0.3,2.2,0.1,99.0,0.0,59916,53170,52035,14762,14762,23,55,157,1374,76,60738,0,7881,52035,23,32,102,1217,12.8,84.8,0.0,0.1,0.2,2.0
E08000013,ST. HELENS,83372,83306,98.2,86.0,85.7,4.9,83.2,0.1,0.3,0.5,1.7,0.1,99.5,1.2,81848,71676,71432,4092,69388,49,247,389,1458,59,82946,1012,10416,71432,49,198,142,1069,12.5,85.7,0.1,0.2,0.2,1.3
E07000197,STAFFORD,61501,61438,94.4,64.8,64.7,7.0,9.9,0.3,0.9,2.1,5.5,0.4,98.8,0.7,58056,39822,39771,4298,6106,159,560,1263,3382,238,60756,431,18285,39771,159,401,703,2119,29.7,64.7,0.3,0.7,1.1,3.4
E07000198,STAFFORDSHIRE MOORLANDS,43845,43757,92.1,29.0,28.0,2.9,2.9,0.6,1.6,3.2,7.7,1.2,98.6,0.0,40364,12731,12294,1257,1257,265,719,1420,3393,516,43238,0,28070,12294,265,454,701,1973,64.0,28.0,0.6,1.0,1.6,4.5
E07000243,STEVENAGE,37582,37572,99.6,88.9,88.9,1.3,1.3,0.0,0.0,0.0,0.4,0.0,99.7,0.0,37430,33418,33405,505,505,0,0,1,142,10,37458,0,4025,33405,0,0,1,141,10.7,88.9,0.0,0.0,0.0,0.4
S12000030,STIRLING,42474,41916,89.4,54.2,52.1,51.1,51.1,1.3,2.8,4.5,9.3,3.0,96.3,0.0,37960,23005,22110,21688,21704,545,1174,1915,3956,1275,40893,0,15850,22110,545,629,741,2041,37.3,52.1,1.3,1.5,1.7,4.8
E08000007,STOCKPORT,129888,129643,98.6,85.0,84.9,2.7,29.4,0.0,0.1,0.2,1.2,0.2,99.3,0.0,128040,110417,110295,3452,38183,25,169,222,1603,249,128952,0,17745,110295,25,144,53,1381,13.7,84.9,0.0,0.1,0.0,1.1
E06000004,STOCKTON-ON-TEES,86645,86611,97.6,90.2,86.3,4.8,4.8,0.1,0.4,0.8,2.4,0.1,98.3,3.6,84565,78114,74753,4164,4164,69,311,689,2046,69,85182,3083,9812,74753,69,242,378,1357,11.3,86.3,0.1,0.3,0.4,1.6
E06000021,STOKE-ON-TRENT,114341,114258,98.5,78.3,77.9,1.0,1.0,0.0,0.0,0.1,1.4,0.1,99.4,0.0,112634,89586,89029,1174,1174,0,22,112,1624,83,113685,0,23605,89029,0,22,90,1512,20.6,77.9,0.0,0.0,0.1,1.3
E07000221,STRATFORD-ON-AVON,59609,59310,94.7,40.8,35.4,12.4,31.2,0.3,0.8,1.4,4.8,0.6,98.2,0.0,56461,24298,21093,7369,18621,157,494,812,2849,368,58558,2,35368,21093,157,337,318,2037,59.3,35.4,0.3,0.6,0.5,3.4
E07000082,STROUD,53203,53145,90.4,17.8,17.8,14.0,14.0,0.4,1.2,2.6,9.5,0.3,95.3,0.3,48109,9488,9460,7425,7425,223,664,1393,5036,186,50709,178,38649,9460,223,441,729,3643,72.6,17.8,0.4,0.8,1.4,6.8
E08000024,SUNDERLAND,129852,129564,97.3,65.5,60.9,7.2,7.2,0.1,0.1,0.4,2.5,0.3,98.6,0.0,126372,85025,79049,9332,9332,68,118,510,3192,348,128052,0,47323,79049,68,50,392,2682,36.4,60.9,0.1,0.0,0.3,2.1
E07000214,SURREY HEATH,36510,36484,98.0,67.8,67.3,7.8,7.8,0.0,0.0,0.1,2.0,0.1,99.9,0.0,35766,24767,24584,2854,2854,0,12,38,718,27,36467,0,11182,24584,0,12,26,680,30.6,67.3,0.0,0.0,0.1,1.9
E09000029,SUTTON,84183,84102,98.4,86.3,82.6,6.3,6.3,0.0,0.0,0.3,1.5,0.1,98.6,0.0,82798,72634,69503,5269,5269,12,19,220,1304,80,82987,0,13295,69503,12,7,201,1084,15.8,82.6,0.0,0.0,0.2,1.3
E07000113,SWALE,62283,62072,94.0,43.2,36.5,6.4,6.4,0.2,0.6,1.5,5.7,0.5,98.8,0.0,58522,26916,22745,3995,3995,111,352,936,3550,322,61514,0,35777,22745,111,241,584,2614,57.4,36.5,0.2,0.4,0.9,4.2
W06000011,SWANSEA,111606,111521,97.9,80.3,77.8,27.8,27.8,0.1,0.2,0.5,2.0,0.2,98.9,52.4,109284,89666,86859,31032,31032,86,223,532,2237,169,110334,58451,22425,86859,86,137,309,1705,20.1,77.8,0.1,0.1,0.3,1.5
E06000030,SWINDON,97307,97291,93.1,82.1,79.8,12.6,12.6,0.0,0.7,1.7,6.8,0.6,93.6,0.0,90638,79891,77693,12223,12223,18,651,1684,6653,615,91079,0,12945,77693,18,633,1033,4969,13.3,79.8,0.0,0.7,1.1,5.1
E08000008,TAMESIDE,104500,104219,97.4,59.2,58.4,18.1,18.1,0.0,0.0,0.1,2.4,0.3,99.5,0.0,101741,61849,61030,18946,18957,2,16,128,2478,281,103967,0,40711,61030,2,14,112,2350,39.0,58.4,0.0,0.0,0.1,2.2
E07000199,TAMWORTH,33331,33297,99.3,87.4,84.2,3.7,82.5,0.0,0.1,0.1,0.6,0.1,99.7,0.0,33103,29133,28071,1227,27502,13,24,38,194,38,33243,0,5032,28071,13,11,14,156,15.1,84.2,0.0,0.0,0.0,0.5
E07000215,TANDRIDGE,36324,36297,94.2,53.6,51.9,11.1,11.1,0.1,0.5,1.0,5.7,0.2,99.7,0.0,34229,19453,18858,4023,4023,42,191,351,2068,79,36202,0,15371,18858,42,149,160,1717,42.3,51.9,0.1,0.4,0.4,4.7
E07000045,TEIGNBRIDGE,61881,61826,89.2,34.9,34.9,8.9,8.9,0.4,1.7,3.6,10.7,0.8,96.9,29.1,55225,21621,21604,5487,5487,269,1026,2216,6601,500,59977,18029,33621,21604,269,757,1190,4385,54.3,34.9,0.4,1.2,1.9,7.1
E06000020,TELFORD AND WREKIN,77723,77579,98.1,81.6,79.1,5.6,5.6,0.1,0.2,0.4,1.7,0.2,99.4,38.2,76230,63424,61505,4385,4385,58,122,280,1349,162,77241,29708,14725,61505,58,64,158,1069,18.9,79.1,0.1,0.1,0.2,1.4
E07000076,TENDRING,70364,70281,95.7,7.6,7.6,7.6,7.6,0.4,0.9,1.8,4.1,0.4,98.2,0.0,67368,5357,5357,5350,5350,264,655,1284,2913,301,69100,0,62011,5357,264,391,629,1629,88.1,7.6,0.4,0.6,0.9,2.3
E07000093,TEST VALLEY,55111,55058,94.2,67.0,66.3,15.0,17.3,0.2,0.7,1.8,5.7,0.5,98.8,0.0,51937,36906,36520,8288,9530,106,398,987,3121,301,54464,0,15417,36520,106,292,589,2134,28.0,66.3,0.2,0.5,1.1,3.9
E07000083,TEWKESBURY,43922,43458,90.8,57.2,54.8,24.2,24.2,0.3,1.4,2.4,8.2,1.6,92.7,0.0,39877,25104,24061,10628,10628,134,598,1065,3581,690,40713,8,15816,24061,134,464,467,2516,36.0,54.8,0.3,1.1,1.1,5.7
E07000114,THANET,68482,68314,97.4,50.8,50.6,50.7,50.7,0.0,0.0,1.0,2.4,0.2,99.7,0.0,66677,34814,34631,34744,34744,3,30,713,1637,170,68282,0,32046,34631,3,27,683,924,46.8,50.6,0.0,0.0,1.0,1.3
E07000102,THREE RIVERS,37830,37812,97.1,80.0,77.8,5.5,5.5,0.2,0.2,0.5,2.8,0.1,99.8,0.0,36746,30268,29424,2096,2096,66,89,183,1066,25,37742,0,7322,29424,66,23,94,883,19.4,77.8,0.2,0.1,0.2,2.3
E06000034,THURROCK,68426,68406,96.6,77.2,76.1,12.8,12.8,0.0,0.3,1.2,3.3,0.1,98.1,0.0,66126,52855,52090,8735,8735,24,180,835,2280,46,67115,0,14036,52090,24,156,655,1445,20.5,76.1,0.0,0.2,1.0,2.1
E07000115,TONBRIDGE AND MALLING,54420,54360,95.1,63.1,60.3,12.0,12.0,0.2,0.5,1.0,4.8,0.3,98.9,0.0,51756,34327,32821,6510,6510,106,245,530,2604,147,53812,0,18935,32821,106,139,285,2074,34.8,60.3,0.2,0.3,0.5,3.8
E06000027,TORBAY,72811,72641,94.6,66.8,61.7,25.1,25.1,0.0,0.0,0.5,5.2,0.3,96.8,0.2,68845,48642,44948,18293,18293,9,11,361,3796,188,70511,125,23897,44948,9,2,350,3435,32.8,61.7,0.0,0.0,0.5,4.7
W06000020,TORFAEN,42443,42422,97.6,51.1,42.0,11.5,11.5,0.1,0.2,0.4,2.3,0.1,99.1,66.8,41431,21671,17841,4862,4862,51,93,180,991,40,42046,28349,23590,17841,51,42,87,811,55.6,42.0,0.1,0.1,0.2,1.9
E07000046,TORRIDGE,31841,31695,81.4,3.5,3.5,3.5,3.5,2.6,7.1,11.4,18.1,1.9,93.0,46.7,25934,1111,1111,1111,1111,836,2269,3635,5761,599,29601,14867,24823,1111,836,1433,1366,2126,78.0,3.5,2.6,4.5,4.3,6.7
E09000030,TOWER HAMLETS,133514,133303,93.5,71.2,68.1,46.9,46.9,0.0,0.0,0.2,6.4,0.2,93.5,0.0,124811,95079,90891,62651,62651,0,1,308,8492,210,124859,0,33920,90891,0,1,307,8184,25.4,68.1,0.0,0.0,0.2,6.1
E08000009,TRAFFORD,100421,100106,98.1,72.8,68.4,2.3,64.9,0.0,0.2,0.2,1.6,0.3,99.2,0.0,98502,73113,68731,2354,65185,41,172,234,1604,327,99608,0,29771,68731,41,131,62,1370,29.6,68.4,0.0,0.1,0.1,1.4
E07000116,TUNBRIDGE WELLS,49124,49056,92.4,49.8,45.6,8.6,8.6,0.1,1.1,2.4,7.5,0.9,98.9,0.0,45385,24478,22409,4218,4218,63,519,1191,3671,452,48562,0,22976,22409,63,456,672,2480,46.8,45.6,0.1,0.9,1.4,5.0
E07000077,UTTLESFORD,37656,37535,89.1,38.9,36.7,19.8,19.8,0.3,1.5,3.8,10.5,1.5,94.6,0.0,33568,14646,13813,7464,7464,130,552,1429,3967,556,35639,0,19755,13813,130,422,877,2538,52.5,36.7,0.3,1.1,2.3,6.7
W06000014,VALE OF GLAMORGAN,59346,59244,96.9,60.3,56.2,22.8,22.8,0.2,0.8,1.1,2.9,0.5,98.6,10.6,57514,35799,33375,13542,13542,129,495,672,1730,268,58540,6310,24139,33375,129,366,177,1058,40.7,56.2,0.2,0.6,0.3,1.8
E07000180,VALE OF WHITE HORSE,58581,58512,96.7,63.7,61.3,16.5,16.5,0.1,0.3,0.6,3.2,0.2,99.0,0.0,56644,37290,35897,9688,9689,65,150,339,1868,102,57995,0,20747,35897,65,85,189,1529,35.4,61.3,0.1,0.1,0.3,2.6
E08000036,WAKEFIELD,150911,150114,96.2,56.0,55.5,21.4,21.4,0.0,0.2,0.5,3.2,0.5,98.4,0.4,145244,84485,83701,32221,32221,53,369,680,4870,828,148481,576,61543,83701,53,316,311,4190,40.8,55.5,0.0,0.2,0.2,2.8
E08000030,WALSALL,112628,112578,98.9,80.4,78.4,11.1,76.1,0.0,0.0,0.4,1.1,0.1,99.4,0.0,111377,90515,88262,12534,85752,2,4,399,1201,69,112007,0,23115,88262,2,2,395,802,20.5,78.4,0.0,0.0,0.4,0.7
E09000031,WALTHAM FOREST,103606,103545,97.2,89.5,88.4,18.7,18.7,0.0,0.0,0.4,2.7,0.1,97.3,0.0,100738,92768,91594,19337,19337,6,10,363,2807,74,100813,0,9144,91594,6,4,353,2444,8.8,88.4,0.0,0.0,0.3,2.4
E09000032,WANDSWORTH,147283,146680,97.4,86.6,80.6,34.8,34.8,0.0,0.0,0.0,2.2,0.4,97.4,0.0,143480,127591,118731,51248,51248,0,13,59,3200,577,143498,0,24749,118731,0,13,46,3141,16.8,80.6,0.0,0.0,0.0,2.1
E06000007,WARRINGTON,93292,93089,97.4,73.0,67.4,2.0,65.0,0.0,0.1,0.1,2.4,0.2,99.5,0.0,90856,68093,62910,1825,60669,21,78,119,2233,218,92870,0,27946,62910,21,57,41,2114,30.0,67.4,0.0,0.1,0.0,2.3
E07000222,WARWICK,64712,64651,98.3,79.1,73.7,7.6,69.7,0.1,0.4,0.6,1.7,0.1,99.4,0.0,63582,51208,47716,4924,45112,60,289,400,1069,75,64348,0,15866,47716,60,229,111,669,24.5,73.7,0.1,0.4,0.2,1.0
E07000103,WATFORD,40172,39923,99.0,91.7,88.5,2.4,2.4,0.0,0.0,0.0,0.4,0.6,99.1,0.0,39773,36856,35546,983,983,0,1,14,150,249,39796,0,4227,35546,0,1,13,136,10.5,88.5,0.0,0.0,0.0,0.3
E07000216,WAVERLEY,53221,53182,94.0,19.7,16.2,5.5,5.5,0.1,0.3,0.7,5.9,0.4,99.7,0.0,50046,10469,8613,2915,2915,46,176,386,3136,218,53063,0,41433,8613,46,130,210,2750,77.9,16.2,0.1,0.2,0.4,5.2
E07000065,WEALDEN,68998,68888,93.7,14.8,14.6,14.5,14.5,0.2,0.6,1.2,6.2,0.6,99.5,0.0,64641,10188,10074,10035,10035,122,422,853,4247,415,68640,0,54567,10074,122,300,431,3394,79.1,14.6,0.2,0.4,0.6,4.9
E07000156,WELLINGBOROUGH,35512,35498,98.1,64.0,63.9,2.4,2.4,0.0,0.4,0.7,1.8,0.1,99.5,14.2,34848,22713,22685,836,836,17,156,245,650,39,35320,5057,12163,22685,17,139,89,405,34.3,63.9,0.0,0.4,0.3,1.1
E07000241,WELWYN HATFIELD,47911,47886,97.7,77.8,75.7,9.1,9.1,0.0,0.0,0.2,2.3,0.1,99.5,0.0,46790,37285,36265,4351,4351,6,16,88,1096,30,47671,0,10525,36265,6,10,72,1008,22.0,75.7,0.0,0.0,0.2,2.1
E06000037,WEST BERKSHIRE,67510,67453,98.0,74.0,69.2,25.2,65.7,0.0,0.2,0.4,1.9,0.2,99.1,0.0,66173,49970,46732,17039,44328,21,104,246,1280,102,66907,0,19441,46732,21,83,142,1034,28.8,69.2,0.0,0.1,0.2,1.5
E07000047,WEST DEVON,24872,24838,78.3,23.5,23.5,23.5,23.5,1.8,5.9,11.7,21.5,1.8,95.4,69.6,19485,5845,5845,5845,5845,447,1465,2911,5353,446,23722,17309,13640,5845,447,1018,1446,2442,54.8,23.5,1.8,4.1,5.8,9.8
S12000039,WEST DUNBARTONSHIRE,44452,44436,98.8,91.0,89.8,0.4,88.6,0.0,0.2,0.4,1.1,0.1,99.2,0.0,43935,40436,39910,198,39366,18,73,180,501,23,44111,0,4025,39910,18,55,107,321,9.1,89.8,0.0,0.1,0.2,0.7
E07000127,WEST LANCASHIRE,48904,48859,94.8,45.2,35.5,29.7,29.8,0.2,0.7,1.3,5.1,0.1,99.0,5.2,46385,22129,17375,14547,14566,97,355,627,2474,64,48423,2559,29010,17375,97,258,272,1847,59.3,35.5,0.2,0.5,0.6,3.8
E07000142,WEST LINDSEY,43475,43292,86.3,33.5,31.4,19.4,19.4,2.0,4.2,6.6,13.3,1.4,97.4,26.5,37502,14582,13669,8446,8446,863,1824,2878,5790,629,42342,11521,23833,13669,863,961,1054,2912,54.8,31.4,2.0,2.2,2.4,6.7
S12000040,WEST LOTHIAN,81659,81605,97.3,69.8,68.5,27.4,67.8,0.1,0.3,0.5,2.6,0.2,99.6,0.0,79476,57015,55969,22407,55353,114,275,418,2129,134,81299,0,23507,55969,114,161,143,1711,28.8,68.5,0.1,0.2,0.2,2.1
E07000181,WEST OXFORDSHIRE,48948,48895,98.1,63.6,56.3,23.2,23.2,0.1,0.2,0.5,1.8,0.2,99.4,0.0,48030,31107,27582,11376,11376,31,109,230,865,99,48653,0,20448,27582,31,78,121,635,41.8,56.3,0.1,0.2,0.2,1.3
E07000245,WEST SUFFOLK,79103,79052,95.5,30.9,24.6,11.6,11.6,0.1,0.4,0.6,4.5,0.3,99.4,0.1,75523,24407,19448,9146,9146,96,285,498,3529,229,78605,109,56075,19448,96,189,213,3031,70.9,24.6,0.1,0.2,0.3,3.8
E09000033,WESTMINSTER,134601,134327,93.2,63.7,62.7,57.3,57.3,0.0,0.0,0.0,6.6,0.2,93.2,0.0,125452,85734,84344,77184,77184,0,0,15,8875,266,125464,0,41108,84344,0,0,15,8860,30.5,62.7,0.0,0.0,0.0,6.6
E08000010,WIGAN,145574,145532,98.4,85.4,84.5,3.7,11.2,0.0,0.1,0.2,1.6,0.1,99.7,0.0,143256,124272,123047,5387,16285,32,108,319,2276,74,145067,52,20209,123047,32,76,211,1957,13.9,84.5,0.0,0.1,0.1,1.3
E06000054,WILTSHIRE,220486,220208,94.4,43.7,42.2,19.3,19.3,0.2,0.7,1.5,5.4,0.5,98.9,1.0,208212,96446,93112,42498,42498,493,1607,3260,11996,1007,218098,2181,115100,93112,493,1114,1653,8736,52.2,42.2,0.2,0.5,0.7,4.0
E07000094,WINCHESTER,52222,52167,92.4,46.2,35.7,7.1,7.1,0.3,1.1,2.0,7.5,0.6,98.3,0.0,48262,24126,18666,3692,3694,174,573,1045,3905,305,51309,0,29596,18666,174,399,472,2860,56.7,35.7,0.3,0.8,0.9,5.5
E06000040,WINDSOR AND MAIDENHEAD,63894,63862,94.8,63.2,58.9,4.5,4.5,0.2,0.3,0.9,5.2,0.2,98.3,0.0,60565,40361,37614,2904,2905,109,212,568,3297,117,62803,0,22951,37614,109,103,356,2729,35.9,58.9,0.2,0.2,0.6,4.3
E08000015,WIRRAL,150048,150005,97.8,71.8,71.8,42.1,42.1,0.0,0.1,0.1,2.1,0.0,99.6,0.0,146816,107760,107689,63099,63099,22,78,204,3189,48,149493,0,39127,107689,22,56,126,2985,26.1,71.8,0.0,0.0,0.1,2.0
E07000217,WOKING,42807,42728,98.2,85.6,83.1,3.2,3.2,0.0,0.3,0.3,1.7,0.2,99.3,0.0,42018,36658,35565,1362,1362,0,134,147,710,90,42495,0,6453,35565,0,134,13,563,15.1,83.1,0.0,0.3,0.0,1.3
E06000041,WOKINGHAM,72702,71614,94.2,70.9,68.3,11.6,66.3,0.1,0.2,0.6,4.3,1.5,96.4,0.0,68521,51570,49645,8432,48194,59,139,458,3093,1119,70050,0,18876,49645,59,80,319,2635,26.0,68.3,0.1,0.1,0.4,3.6
E08000031,WOLVERHAMPTON,110569,110366,99.0,93.3,92.1,1.7,2.0,0.0,0.0,0.0,0.8,0.2,99.2,5.0,109473,103110,101792,1934,2162,0,1,23,893,200,109719,5485,7681,101792,0,1,22,870,6.9,92.1,0.0,0.0,0.0,0.8
E07000237,WORCESTER,45786,45747,99.1,22.0,10.7,2.5,2.5,0.0,0.0,0.0,0.9,0.1,99.6,0.0,45353,10060,4906,1156,1156,0,0,0,394,39,45620,21,40447,4906,0,0,0,394,88.3,10.7,0.0,0.0,0.0,0.9
E07000229,WORTHING,48998,48988,99.4,92.3,91.6,33.8,33.8,0.0,0.0,0.0,0.6,0.0,99.8,0.0,48702,45206,44862,16538,16538,3,3,3,286,10,48922,0,3840,44862,3,0,0,283,7.8,91.6,0.0,0.0,0.0,0.6
W06000006,WREXHAM,61378,60866,95.2,38.3,37.7,37.3,37.3,0.3,0.9,1.7,3.9,1.2,97.9,44.3,58442,23537,23140,22915,22915,176,559,1015,2424,758,60100,27211,35302,23140,176,383,456,1409,57.5,37.7,0.3,0.6,0.7,2.3
E07000238,WYCHAVON,57601,57365,94.2,19.9,15.8,8.1,8.2,0.1,0.7,1.2,5.4,0.6,98.8,0.2,54277,11481,9103,4665,4740,76,376,707,3088,372,56902,134,45174,9103,76,300,331,2381,78.4,15.8,0.1,0.5,0.6,4.1
E07000128,WYRE,53080,53015,95.5,23.5,23.5,23.1,23.1,0.1,0.3,0.5,4.3,0.1,99.2,0.3,50710,12492,12492,12253,12253,54,140,278,2305,76,52670,179,38218,12492,54,86,138,2027,72.0,23.5,0.1,0.2,0.3,3.8
E07000239,WYRE FOREST,45325,45290,96.9,50.1,50.0,1.9,50.0,0.2,0.5,0.7,3.0,0.3,99.7,3.5,43941,22721,22651,869,22651,79,208,336,1349,146,45172,1602,21290,22651,79,129,128,1013,47.0,50.0,0.2,0.3,0.3,2.2
E06000014,YORK,89632,89395,95.3,77.6,74.3,57.4,57.4,0.0,0.2,0.8,4.4,0.3,97.1,3.6,85442,69573,66611,51447,51447,30,167,678,3953,252,87028,3212,18831,66611,30,137,511,3275,21.0,74.3,0.0,0.2,0.6,3.7
